ησυχάστε	ησυχάζω	ρήμα	ενεργητική, αόριστος, προστακτική, πληθυντικός, 2ο πρόσωπο
γελαστή	γελαστός	επίθετο	θηλυκό, ενικός, ονομαστική
δυστυχισμένη	δυστυχισμένος	επίθετο	θηλυκό, ενικός, ονομαστική
πρωταγωνιστούν	πρωταγωνιστώ	ρήμα	ενεργητική, ενεστώτας, οριστική, πληθυντικός, 3ο πρόσωπο
διασκεδαστικό	διασκεδαστικός	επίθετο	αρσενικό, ενικός, αιτιατική
ημίχρονο	ημίχρονο	ουσιαστικό	ουδέτερο, ενικός, κλητική
διασκεδαστικά	διασκεδαστικός	επίθετο	ουδέτερο, πληθυντικός, αιτιατική
εμφανιστεί	εμφανίζω	ρήμα	παθητική, αόριστος, υποτακτική, ενικός, 3ο πρόσωπο
κοσμικών	κοσμικός	επίθετο	θηλυκό, πληθυντικός, γενική
αντίκρυ	αντίκρυ	επίρρημα	
περιστατικά	περιστατικό	ουσιαστικό	ουδέτερο, πληθυντικός, αιτιατική
περίπλοκες	περίπλοκος	επίθετο	θηλυκό, πληθυντικός, ονομαστική
ξεκαρδίστηκαν	ξεκαρδίζομαι	ρήμα	παθητική, αόριστος, οριστική, πληθυντικός, 3ο πρόσωπο
αφάνταστα	αφάνταστος	επίθετο	ουδέτερο, πληθυντικός, αιτιατική
μέτρο	μέτρο	ουσιαστικό	ουδέτερο, ενικός, κλητική
μέτρα	μέτρο	ουσιαστικό	ουδέτερο, πληθυντικός, αιτιατική
ξαπλωτές	ξαπλωτός	επίθετο	θηλυκό, πληθυντικός, ονομαστική
ξάπλωσε	ξαπλώνω	ρήμα	ενεργητική, αόριστος, οριστική, ενικός, 3ο πρόσωπο
πλεονεκτήματα	πλεονέκτημα	ουσιαστικό	ουδέτερο, πληθυντικός, αιτιατική
ξαπλωμένος	ξαπλώνω	ρήμα	παθητική, παρακείμενος, μετοχή, , 
πρωταγωνιστεί	πρωταγωνιστώ	ρήμα	ενεργητική, ενεστώτας, οριστική, ενικός, 3ο πρόσωπο
αρχιτεκτονική	αρχιτεκτονικός	επίθετο	θηλυκό, ενικός, ονομαστική
ανάλαφρους	ανάλαφρος	επίθετο	αρσενικό, πληθυντικός, αιτιατική
σκεπαστούς	σκεπαστός	επίθετο	αρσενικό, πληθυντικός, αιτιατική
αρχιτεκτονικό	αρχιτεκτονικός	επίθετο	αρσενικό, ενικός, αιτιατική
κατασκηνώσουμε	κατασκηνώνω	ρήμα	ενεργητική, αόριστος, υποτακτική, πληθυντικός, 1ο πρόσωπο
πρωταγωνιστές	πρωταγωνιστής	ουσιαστικό	αρσενικό, πληθυντικός, αιτιατική
φωναχτά	φωναχτός	επίθετο	ουδέτερο, πληθυντικός, αιτιατική
μικροσκοπικά	μικροσκοπικός	επίθετο	ουδέτερο, πληθυντικός, αιτιατική
μανούβρες	μανούβρα	ουσιαστικό	θηλυκό, πληθυντικός, αιτιατική
μικροσκοπικό	μικροσκοπικός	επίθετο	αρσενικό, ενικός, αιτιατική
δάχτυλα	δάχτυλο	ουσιαστικό	ουδέτερο, πληθυντικός, αιτιατική
αδέσποτου	αδέσποτος	επίθετο	ουδέτερο, ενικός, γενική
καθιστούς	καθιστός	επίθετο	αρσενικό, πληθυντικός, αιτιατική
νηστικοί	νηστικός	επίθετο	αρσενικό, πληθυντικός, κλητική
φανταστεί	φαντάζομαι	ρήμα	παθητική, αόριστος, υποτακτική, ενικός, 3ο πρόσωπο
επίδραση	επίδραση	ουσιαστικό	θηλυκό, ενικός, κλητική
ελαφρά	ελαφρός	επίθετο	ουδέτερο, πληθυντικός, αιτιατική
αντίκρισε	αντικρίζω	ρήμα	ενεργητική, αόριστος, οριστική, ενικός, 3ο πρόσωπο
παραμικρή	παραμικρός	επίθετο	θηλυκό, ενικός, ονομαστική
κατρακυλάει	κατρακυλώ	ρήμα	ενεργητική, ενεστώτας, οριστική, ενικός, 3ο πρόσωπο
οικισμού	οικισμός	ουσιαστικό	αρσενικό, ενικός, γενική
νύχτα	νύχτα	ουσιαστικό	θηλυκό, ενικός, κλητική
ορισμένες	ορισμένος	επίθετο	θηλυκό, πληθυντικός, ονομαστική
αβάσταχτο	αβάσταχτος	επίθετο	αρσενικό, ενικός, αιτιατική
αναγκάστηκε	αναγκάζω	ρήμα	παθητική, αόριστος, οριστική, ενικός, 3ο πρόσωπο
αντικρίζουν	αντικρίζω	ρήμα	ενεργητική, ενεστώτας, οριστική, πληθυντικός, 3ο πρόσωπο
ξάπλωσαν	ξαπλώνω	ρήμα	ενεργητική, αόριστος, οριστική, πληθυντικός, 3ο πρόσωπο
αυτοσχεδίαζε	αυτοσχεδιάζω	ρήμα	ενεργητική, παρατατικός, οριστική, ενικός, 3ο πρόσωπο
πέρασμα	πέρασμα	ουσιαστικό	ουδέτερο, ενικός, κλητική
μανιασμένα	μανιασμένος	επίθετο	ουδέτερο, πληθυντικός, αιτιατική
στενόμακρη	στενόμακρος	επίθετο	θηλυκό, ενικός, ονομαστική
κοσμάκη	κοσμάκης	ουσιαστικό	αρσενικό, ενικός, κλητική
πυκνές	πυκνός	επίθετο	θηλυκό, πληθυντικός, ονομαστική
ξέγνοιαστος	ξέγνοιαστος	επίθετο	αρσενικό, ενικός, ονομαστική
εκνευριστικό	εκνευριστικός	επίθετο	αρσενικό, ενικός, αιτιατική
τρομοκρατούσα	τρομοκρατώ	ρήμα	ενεργητική, παρατατικός, οριστική, ενικός, 1ο πρόσωπο
υπερρεαλιστής	υπερρεαλιστής	ουσιαστικό	αρσενικό, ενικός, ονομαστική
συνιστά	συνιστώ	ρήμα	ενεργητική, ενεστώτας, οριστική, ενικός, 3ο πρόσωπο
λεφτά	λεφτάς	ουσιαστικό	αρσενικό, ενικός, κλητική
παίχτη	παίχτης	ουσιαστικό	αρσενικό, ενικός, κλητική
ζεστή	ζεστός	επίθετο	θηλυκό, ενικός, ονομαστική
ζεστά	ζεστός	επίθετο	ουδέτερο, πληθυντικός, αιτιατική
κέδρα	κέδρο	ουσιαστικό	ουδέτερο, πληθυντικός, αιτιατική
αποφασιστικά	αποφασιστικός	επίθετο	ουδέτερο, πληθυντικός, αιτιατική
αναστέναξε	αναστενάζω	ρήμα	ενεργητική, αόριστος, οριστική, ενικός, 3ο πρόσωπο
χαρακτήρα	χαρακτήρας	ουσιαστικό	αρσενικό, ενικός, κλητική
ακατάστατες	ακατάστατος	επίθετο	θηλυκό, πληθυντικός, ονομαστική
κοιμισμένα	κοιμισμένος	επίθετο	ουδέτερο, πληθυντικός, αιτιατική
σωστά	σωστός	επίθετο	ουδέτερο, πληθυντικός, αιτιατική
δίπλα	δίπλα	ουσιαστικό	θηλυκό, ενικός, κλητική
τετράγωνη	τετράγωνος	επίθετο	θηλυκό, ενικός, ονομαστική
σκοντάφτοντας	σκοντάβω	ρήμα	ενεργητική, ενεστώτας, μετοχή, , 
ξεγελάστηκε	ξεγελώ	ρήμα	παθητική, αόριστος, οριστική, ενικός, 3ο πρόσωπο
εμφανίστηκε	εμφανίζω	ρήμα	παθητική, αόριστος, οριστική, ενικός, 3ο πρόσωπο
κίτρινα	κίτρινος	επίθετο	ουδέτερο, πληθυντικός, αιτιατική
κίτρινη	κίτρινος	επίθετο	θηλυκό, ενικός, ονομαστική
μεθυσμένος	μεθυσμένος	επίθετο	αρσενικό, ενικός, ονομαστική
καταπράσινα	καταπράσινος	επίθετο	ουδέτερο, πληθυντικός, αιτιατική
αντιπροσωπευτικές	αντιπροσωπευτικός	επίθετο	θηλυκό, πληθυντικός, ονομαστική
παραθεριστές	παραθεριστής	ουσιαστικό	αρσενικό, πληθυντικός, αιτιατική
ξεσχίσει	ξεσχίζω	ρήμα	ενεργητική, αόριστος, υποτακτική, ενικός, 3ο πρόσωπο
επισκεφτήκαμε	επισκέπτομαι	ρήμα	παθητική, αόριστος, οριστική, πληθυντικός, 1ο πρόσωπο
μικρές	μικρός	επίθετο	θηλυκό, πληθυντικός, ονομαστική
δάσκαλος	δάσκαλος	ουσιαστικό	αρσενικό, ενικός, ονομαστική
νηστεία	νηστεία	ουσιαστικό	θηλυκό, ενικός, κλητική
μυριστούν	μυρίζω	ρήμα	παθητική, αόριστος, υποτακτική, πληθυντικός, 3ο πρόσωπο
ηλιαχτίδες	ηλιαχτίδα	ουσιαστικό	θηλυκό, πληθυντικός, αιτιατική
καταυλισμούς	καταυλισμός	ουσιαστικό	αρσενικό, πληθυντικός, αιτιατική
παραστάσεως	παράσταση	ουσιαστικό	θηλυκό, ενικός, γενική
κάθιδροι	κάθιδρος	επίθετο	αρσενικό, πληθυντικός, κλητική
θερμοκρασία	θερμοκρασία	ουσιαστικό	θηλυκό, ενικός, κλητική
καταστάσεις	κατάσταση	ουσιαστικό	θηλυκό, πληθυντικός, αιτιατική
ποδοσφαιρικός	ποδοσφαιρικός	επίθετο	αρσενικό, ενικός, ονομαστική
απρόσεκτα	απρόσεκτος	επίθετο	ουδέτερο, πληθυντικός, αιτιατική
παραστάσεις	παράσταση	ουσιαστικό	θηλυκό, πληθυντικός, αιτιατική
μικρού	μικρός	επίθετο	ουδέτερο, ενικός, γενική
μάλιστα	μάλιστα	 επίρρημα	 βεβαιωτικό
εφοπλιστής	εφοπλιστής	ουσιαστικό	αρσενικό, ενικός, ονομαστική
μικροί	μικρός	επίθετο	αρσενικό, πληθυντικός, κλητική
απόμακρη	απόμακρος	επίθετο	θηλυκό, ενικός, ονομαστική
τινάχτηκε	τινάζω	ρήμα	παθητική, αόριστος, οριστική, ενικός, 3ο πρόσωπο
εργαστεί	εργάζομαι	ρήμα	παθητική, αόριστος, υποτακτική, ενικός, 3ο πρόσωπο
πατρικό	πατρικός	επίθετο	αρσενικό, ενικός, αιτιατική
κυκλάμινο	κυκλάμινο	ουσιαστικό	ουδέτερο, ενικός, κλητική
δέσμες	δέσμη	ουσιαστικό	θηλυκό, πληθυντικός, αιτιατική
πατρική	πατρικός	επίθετο	θηλυκό, ενικός, ονομαστική
ευχαριστούν	ευχαριστώ	ρήμα	ενεργητική, ενεστώτας, οριστική, πληθυντικός, 3ο πρόσωπο
δάσκαλο	δάσκαλος	ουσιαστικό	αρσενικό, ενικός, αιτιατική
ξεχνάς	ξεχνώ	ρήμα	ενεργητική, ενεστώτας, οριστική, ενικός, 2ο πρόσωπο
εγκατάστασης	εγκατάσταση	ουσιαστικό	θηλυκό, ενικός, γενική
μετράει	μετρώ	ρήμα	ενεργητική, ενεστώτας, οριστική, ενικός, 3ο πρόσωπο
μέχρι	μέχρι	πρόθεση	
νηστικός	νηστικός	επίθετο	αρσενικό, ενικός, ονομαστική
διάβασμα	διάβασμα	ουσιαστικό	ουδέτερο, ενικός, κλητική
απομακρύνει	απομακρύνω	ρήμα	ενεργητική, αόριστος, υποτακτική, ενικός, 3ο πρόσωπο
τέκνον	τέκνο	ουσιαστικό	ουδέτερο, ενικός, ονομαστική
ζωγράφος	ζωγράφος	ουσιαστικό	θηλυκό, ενικός, ονομαστική
ενοχλούν	ενοχλώ	ρήμα	ενεργητική, ενεστώτας, οριστική, πληθυντικός, 3ο πρόσωπο
λασκάρισε	λασκέρνω	ρήμα	ενεργητική, αόριστος, οριστική, ενικός, 3ο πρόσωπο
αντιπροσωπευτικό	αντιπροσωπευτικός	επίθετο	αρσενικό, ενικός, αιτιατική
έξυπνη	έξυπνος	επίθετο	θηλυκό, ενικός, ονομαστική
ανάλαφρα	ανάλαφρος	επίθετο	ουδέτερο, πληθυντικός, αιτιατική
ζέσταιναν	ζεσταίνω	ρήμα	ενεργητική, παρατατικός, οριστική, πληθυντικός, 3ο πρόσωπο
εξυπνάδα	εξυπνάδα	ουσιαστικό	θηλυκό, ενικός, κλητική
φωσφορίζουν	φωσφορίζω	ρήμα	ενεργητική, ενεστώτας, οριστική, πληθυντικός, 3ο πρόσωπο
ρεαλιστική	ρεαλιστικός	επίθετο	θηλυκό, ενικός, ονομαστική
αναγνωρίσει	αναγνωρίζω	ρήμα	ενεργητική, αόριστος, υποτακτική, ενικός, 3ο πρόσωπο
ρεαλιστικό	ρεαλιστικός	επίθετο	αρσενικό, ενικός, αιτιατική
δίσκος	δίσκος	ουσιαστικό	αρσενικό, ενικός, ονομαστική
μικρέ	μικρός	επίθετο	αρσενικό, ενικός, κλητική
μικρά	μικρός	επίθετο	ουδέτερο, πληθυντικός, αιτιατική
μικρή	μικρός	επίθετο	θηλυκό, ενικός, ονομαστική
βιοτεχνική	βιοτεχνικός	επίθετο	θηλυκό, ενικός, ονομαστική
αναρωτιόμασταν	αναρωτιέμαι	ρήμα	παθητική, παρατατικός, οριστική, πληθυντικός, 1ο πρόσωπο
αμέτρητα	αμέτρητος	επίθετο	ουδέτερο, πληθυντικός, αιτιατική
αναπαράσταση	αναπαράσταση	ουσιαστικό	θηλυκό, ενικός, κλητική
χρωματιστές	χρωματιστός	επίθετο	θηλυκό, πληθυντικός, ονομαστική
βιβλίο	βιβλίο	ουσιαστικό	ουδέτερο, ενικός, κλητική
ολάνοιχτα	ολάνοιχτος	επίθετο	ουδέτερο, πληθυντικός, αιτιατική
διαπίστωσε	διαπιστώνω	ρήμα	ενεργητική, αόριστος, οριστική, ενικός, 3ο πρόσωπο
βιβλία	βιβλίο	ουσιαστικό	ουδέτερο, πληθυντικός, αιτιατική
ηρεμήστε	ηρεμώ	ρήμα	ενεργητική, αόριστος, προστακτική, πληθυντικός, 2ο πρόσωπο
συναίσθημα	συναίσθημα	ουσιαστικό	ουδέτερο, ενικός, κλητική
συριστικό	συριστικός	επίθετο	αρσενικό, ενικός, αιτιατική
ζέστη	ζέστη	ουσιαστικό	θηλυκό, ενικός, κλητική
χειροκροτημάτων	χειροκρότημα	ουσιαστικό	ουδέτερο, πληθυντικός, γενική
αεροστάτων	αερόστατο	ουσιαστικό	ουδέτερο, πληθυντικός, γενική
αναμφισβήτητα	αναμφισβήτητος	επίθετο	ουδέτερο, πληθυντικός, αιτιατική
αποτράβηξε	αποτραβώ	ρήμα	ενεργητική, αόριστος, οριστική, ενικός, 3ο πρόσωπο
ξεσκίζει	ξεσκίζω	ρήμα	ενεργητική, ενεστώτας, οριστική, ενικός, 3ο πρόσωπο
τετραπέρατο	τετραπέρατος	επίθετο	αρσενικό, ενικός, αιτιατική
συναθροίζουν	συναθροίζω	ρήμα	ενεργητική, ενεστώτας, οριστική, πληθυντικός, 3ο πρόσωπο
εξαφανίστηκε	εξαφανίζω	ρήμα	παθητική, αόριστος, οριστική, ενικός, 3ο πρόσωπο
συχνά	συχνός	επίθετο	ουδέτερο, πληθυντικός, αιτιατική
ολοκληρωτικά	ολοκληρωτικός	επίθετο	ουδέτερο, πληθυντικός, αιτιατική
αποκρίθηκε	αποκρίνομαι	ρήμα	παθητική, αόριστος, οριστική, ενικός, 3ο πρόσωπο
ξένοιαστη	ξένοιαστος	επίθετο	θηλυκό, ενικός, ονομαστική
δασκάλου	δάσκαλος	ουσιαστικό	αρσενικό, ενικός, γενική
οικοτροφεία	οικοτροφείο	ουσιαστικό	ουδέτερο, πληθυντικός, αιτιατική
παράσταση	παράσταση	ουσιαστικό	θηλυκό, ενικός, κλητική
εξέδρας	εξέδρα	ουσιαστικό	θηλυκό, ενικός, γενική
λάκτισμα	λάκτισμα	ουσιαστικό	ουδέτερο, ενικός, κλητική
ξύπνα	ξυπνώ	ρήμα	ενεργητική, ενεστώτας, προστακτική, ενικός, 2ο πρόσωπο
πείσμα	πείσμα	ουσιαστικό	ουδέτερο, ενικός, κλητική
επίσκεψη	επίσκεψη	ουσιαστικό	θηλυκό, ενικός, κλητική
δυνάστη	δυνάστης	ουσιαστικό	αρσενικό, ενικός, κλητική
έξυπνος	έξυπνος	επίθετο	αρσενικό, ενικός, ονομαστική
δυστυχισμένους	δυστυχισμένος	επίθετο	αρσενικό, πληθυντικός, αιτιατική
κανονίστηκε	κανονίζω	ρήμα	παθητική, αόριστος, οριστική, ενικός, 3ο πρόσωπο
δυσχερείς	δυσχερής	επίθετο	θηλυκό, πληθυντικός, ονομαστική
επικρατήσει	επικρατώ	ρήμα	ενεργητική, αόριστος, υποτακτική, ενικός, 3ο πρόσωπο
αναστατώσεων	αναστάτωση	ουσιαστικό	θηλυκό, πληθυντικός, γενική
επιδρομών	επιδρομή	ουσιαστικό	θηλυκό, πληθυντικός, γενική
απελπιστικό	απελπιστικός	επίθετο	αρσενικό, ενικός, αιτιατική
ανάκρισης	ανάκριση	ουσιαστικό	θηλυκό, ενικός, γενική
κακάρισμα	κακάρισμα	ουσιαστικό	ουδέτερο, ενικός, κλητική
οικοδέσποινας	οικοδέσποινα	ουσιαστικό	θηλυκό, ενικός, γενική
δασκάλα	δασκάλα	ουσιαστικό	θηλυκό, ενικός, κλητική
παροτρύνει	παροτρύνω	ρήμα	ενεργητική, αόριστος, υποτακτική, ενικός, 3ο πρόσωπο
παράστασης	παράσταση	ουσιαστικό	θηλυκό, ενικός, γενική
βάφτηκαν	βάφω	ρήμα	παθητική, αόριστος, οριστική, πληθυντικός, 3ο πρόσωπο
ανατριχιαστική	ανατριχιαστικός	επίθετο	θηλυκό, ενικός, ονομαστική
αριστερή	αριστερός	επίθετο	θηλυκό, ενικός, ονομαστική
αριστερά	αριστερός	επίθετο	ουδέτερο, πληθυντικός, αιτιατική
ζεσταίνονται	ζεσταίνω	ρήμα	παθητική, ενεστώτας, οριστική, πληθυντικός, 3ο πρόσωπο
διπλά	διπλός	επίθετο	ουδέτερο, πληθυντικός, αιτιατική
εξελιχτεί	εξελίσσω	ρήμα	παθητική, αόριστος, υποτακτική, ενικός, 3ο πρόσωπο
γυμναστική	γυμναστικός	επίθετο	θηλυκό, ενικός, ονομαστική
επιπλήξεις	επιπλήττω	ρήμα	ενεργητική, αόριστος, υποτακτική, ενικός, 2ο πρόσωπο
παίχτες	παίχτης	ουσιαστικό	αρσενικό, πληθυντικός, αιτιατική
παίχτης	παίχτης	ουσιαστικό	αρσενικό, ενικός, ονομαστική
βασανιστικά	βασανιστικός	επίθετο	ουδέτερο, πληθυντικός, αιτιατική
εύθικτη	εύθικτος	επίθετο	θηλυκό, ενικός, ονομαστική
πατρίδας	πατρίδα	ουσιαστικό	θηλυκό, ενικός, γενική
συνωστισμός	συνωστισμός	ουσιαστικό	αρσενικό, ενικός, ονομαστική
πυκνή	πυκνός	επίθετο	θηλυκό, ενικός, ονομαστική
απείραχτη	απείραχτος	επίθετο	θηλυκό, ενικός, ονομαστική
απείραχτο	απείραχτος	επίθετο	αρσενικό, ενικός, αιτιατική
ορισμένα	ορισμένος	επίθετο	ουδέτερο, πληθυντικός, αιτιατική
ξακουσμένου	ξακουσμένος	επίθετο	ουδέτερο, ενικός, γενική
καταπληκτική	καταπληκτικός	επίθετο	θηλυκό, ενικός, ονομαστική
αμέτρητες	αμέτρητος	επίθετο	θηλυκό, πληθυντικός, ονομαστική
ζεσταίνεται	ζεσταίνω	ρήμα	παθητική, ενεστώτας, οριστική, ενικός, 3ο πρόσωπο
πίστεψέ	πιστεύω	ρήμα	ενεργητική, αόριστος, προστακτική, ενικός, 2ο πρόσωπο
ποδοσφαιρικό	ποδοσφαιρικός	επίθετο	αρσενικό, ενικός, αιτιατική
αναποδογυρίστηκε	αναποδογυρίζω	ρήμα	παθητική, αόριστος, οριστική, ενικός, 3ο πρόσωπο
αεροπλάνων	αεροπλάνο	ουσιαστικό	ουδέτερο, πληθυντικός, γενική
απεγνωσμένο	απεγνωσμένος	επίθετο	αρσενικό, ενικός, αιτιατική
τρομαχτικά	τρομαχτικός	επίθετο	ουδέτερο, πληθυντικός, αιτιατική
λιγνά	λιγνός	επίθετο	ουδέτερο, πληθυντικός, αιτιατική
ψιθυριστά	ψιθυριστός	επίθετο	ουδέτερο, πληθυντικός, αιτιατική
μικρογραφιών	μικρογραφία	ουσιαστικό	θηλυκό, πληθυντικός, γενική
παιχνίδι	παιχνίδι	ουσιαστικό	ουδέτερο, ενικός, κλητική
ζωγραφίζω	ζωγραφίζω	ρήμα	ενεργητική, ενεστώτας, οριστική, ενικός, 1ο πρόσωπο
βιβλίο	βιβλίο	ουσιαστικό	ουδέτερο, ενικός, κλητική
συνηθισμένων	συνηθισμένος	επίθετο	θηλυκό, πληθυντικός, γενική
λίτρες	λίτρα	ουσιαστικό	θηλυκό, πληθυντικός, αιτιατική
διδασκαλία	διδασκαλία	ουσιαστικό	θηλυκό, ενικός, κλητική
συμπρωταγωνιστές	συμπρωταγωνιστής	ουσιαστικό	αρσενικό, πληθυντικός, αιτιατική
σαρκαστική	σαρκαστικός	επίθετο	θηλυκό, ενικός, ονομαστική
πίστεψε	πιστεύω	ρήμα	ενεργητική, αόριστος, οριστική, ενικός, 3ο πρόσωπο
φανταστικές	φανταστικός	επίθετο	θηλυκό, πληθυντικός, ονομαστική
όπισθεν	όπισθεν	επίρρημα	
κατατροπώνω	κατατροπώνω	ρήμα	ενεργητική, ενεστώτας, οριστική, ενικός, 1ο πρόσωπο
ελαφρόπετρας	ελαφρόπετρα	ουσιαστικό	θηλυκό, ενικός, γενική
αναπαραστάσεις	αναπαράσταση	ουσιαστικό	θηλυκό, πληθυντικός, αιτιατική
μπαστούνι	μπαστούνι	ουσιαστικό	ουδέτερο, ενικός, κλητική
κοσμούν	κοσμώ	ρήμα	ενεργητική, ενεστώτας, οριστική, πληθυντικός, 3ο πρόσωπο
πατρίδα	πατρίδα	ουσιαστικό	θηλυκό, ενικός, κλητική
κυριολεκτικά	κυριολεκτικός	επίθετο	ουδέτερο, πληθυντικός, αιτιατική
ευτυχισμένους	ευτυχισμένος	επίθετο	αρσενικό, πληθυντικός, αιτιατική
ξέσπασε	ξεσπώ	ρήμα	ενεργητική, αόριστος, οριστική, ενικός, 3ο πρόσωπο
προσεχτικά	προσεχτικός	επίθετο	ουδέτερο, πληθυντικός, αιτιατική
κατάσταση	κατάσταση	ουσιαστικό	θηλυκό, ενικός, κλητική
κάλεσμα	κάλεσμα	ουσιαστικό	ουδέτερο, ενικός, κλητική
χαρακτηριστικά	χαρακτηριστικός	επίθετο	ουδέτερο, πληθυντικός, αιτιατική
επιστολές	επιστολή	ουσιαστικό	θηλυκό, πληθυντικός, αιτιατική
δύστυχος	δύστυχος	επίθετο	αρσενικό, ενικός, ονομαστική
παίκτες	παίκτης	ουσιαστικό	αρσενικό, πληθυντικός, αιτιατική
πανέξυπνη	πανέξυπνος	επίθετο	θηλυκό, ενικός, ονομαστική
λούστε	λούζω	ρήμα	ενεργητική, αόριστος, προστακτική, πληθυντικός, 2ο πρόσωπο
τετραπέρατος	τετραπέρατος	επίθετο	αρσενικό, ενικός, ονομαστική
πρωταγωνιστήσουν	πρωταγωνιστώ	ρήμα	ενεργητική, αόριστος, υποτακτική, πληθυντικός, 3ο πρόσωπο
φούσκωνε	φουσκώνω	ρήμα	ενεργητική, παρατατικός, οριστική, ενικός, 3ο πρόσωπο
αποσπάσματα	απόσπασμα	ουσιαστικό	ουδέτερο, πληθυντικός, αιτιατική
περασμένα	περασμένος	επίθετο	ουδέτερο, πληθυντικός, αιτιατική
ευτυχισμένοι	ευτυχισμένος	επίθετο	αρσενικό, πληθυντικός, κλητική
τοιχογραφίες	τοιχογραφία	ουσιαστικό	θηλυκό, πληθυντικός, αιτιατική
αποπροσανατολισμένος	αποπροσανατολίζω	ρήμα	παθητική, παρακείμενος, μετοχή, , 
λαχταράει	λαχταρώ	ρήμα	ενεργητική, ενεστώτας, οριστική, ενικός, 3ο πρόσωπο
δαιμονισμένοι	δαιμονισμένος	επίθετο	αρσενικό, πληθυντικός, κλητική
νηστικά	νηστικός	επίθετο	ουδέτερο, πληθυντικός, αιτιατική
μούτρα	μούτρο	ουσιαστικό	ουδέτερο, πληθυντικός, αιτιατική
δύσκολο	δύσκολος	επίθετο	αρσενικό, ενικός, αιτιατική
δύσκολα	δύσκολος	επίθετο	ουδέτερο, πληθυντικός, αιτιατική
εξέδρα	εξέδρα	ουσιαστικό	θηλυκό, ενικός, κλητική
ζωγραφιά	ζωγραφιά	ουσιαστικό	θηλυκό, ενικός, κλητική
επιδράσεις	επιδρώ	ρήμα	ενεργητική, αόριστος, υποτακτική, ενικός, 2ο πρόσωπο
συγκεκριμένο	συγκεκριμένος	επίθετο	αρσενικό, ενικός, αιτιατική
δέχτηκε	δέχομαι	ρήμα	παθητική, αόριστος, οριστική, ενικός, 3ο πρόσωπο
ευτυχισμένο	ευτυχισμένος	επίθετο	αρσενικό, ενικός, αιτιατική
συναισθήματα	συναίσθημα	ουσιαστικό	ουδέτερο, πληθυντικός, αιτιατική
ευχάριστη	ευχάριστος	επίθετο	θηλυκό, ενικός, ονομαστική
ευχάριστα	ευχάριστος	επίθετο	ουδέτερο, πληθυντικός, αιτιατική
χαρακτηρίζουν	χαρακτηρίζω	ρήμα	ενεργητική, ενεστώτας, οριστική, πληθυντικός, 3ο πρόσωπο
ζωγραφική	ζωγραφική	ουσιαστικό	θηλυκό, ενικός, κλητική
καλλιτεχνική	καλλιτεχνικός	επίθετο	θηλυκό, ενικός, ονομαστική
αλάνθαστος	αλάνθαστος	επίθετο	αρσενικό, ενικός, ονομαστική
αρπάχτηκε	αρπάζω	ρήμα	παθητική, αόριστος, οριστική, ενικός, 3ο πρόσωπο
αποτέλεσμα	αποτέλεσμα	ουσιαστικό	ουδέτερο, ενικός, κλητική
επικρατεί	επικρατώ	ρήμα	ενεργητική, ενεστώτας, οριστική, ενικός, 3ο πρόσωπο
διδακτικών	διδακτικός	επίθετο	θηλυκό, πληθυντικός, γενική
επαναστάσεως	επανάσταση	ουσιαστικό	θηλυκό, ενικός, γενική
ξύπνησε	ξυπνώ	ρήμα	ενεργητική, αόριστος, οριστική, ενικός, 3ο πρόσωπο
εξαγνίζει	εξαγνίζω	ρήμα	ενεργητική, ενεστώτας, οριστική, ενικός, 3ο πρόσωπο
ξεχνάμε	ξεχνώ	ρήμα	ενεργητική, ενεστώτας, οριστική, πληθυντικός, 1ο πρόσωπο
λουστεί	λούζω	ρήμα	παθητική, αόριστος, υποτακτική, ενικός, 3ο πρόσωπο
αυτοκρατορίας	αυτοκρατορία	ουσιαστικό	θηλυκό, ενικός, γενική
κλονίστηκε	κλονίζω	ρήμα	παθητική, αόριστος, οριστική, ενικός, 3ο πρόσωπο
αριστοκρατική	αριστοκρατικός	επίθετο	θηλυκό, ενικός, ονομαστική
συνάχτηκαν	συνάζω	ρήμα	παθητική, αόριστος, οριστική, πληθυντικός, 3ο πρόσωπο
προσεκτικό	προσεκτικός	επίθετο	αρσενικό, ενικός, αιτιατική
υπερασπίσουν	υπερασπίζω	ρήμα	ενεργητική, αόριστος, υποτακτική, πληθυντικός, 3ο πρόσωπο
περασμένους	περασμένος	επίθετο	αρσενικό, πληθυντικός, αιτιατική
κιτρινίζουν	κιτρινίζω	ρήμα	ενεργητική, ενεστώτας, οριστική, πληθυντικός, 3ο πρόσωπο
συγκλονιστικά	συγκλονιστικός	επίθετο	ουδέτερο, πληθυντικός, αιτιατική
κουρασμένος	κουράζω	ρήμα	παθητική, παρακείμενος, μετοχή, , 
απελπισμένα	απελπισμένος	επίθετο	ουδέτερο, πληθυντικός, αιτιατική
αυγούστου	αύγουστος	ουσιαστικό	αρσενικό, ενικός, γενική
