τρούλο	τρούλος	ουσιαστικό	αρσενικό, ενικός, αιτιατική
τρίτης	τρίτος	επίθετο	θηλυκό, ενικός, γενική
τρόπο	τρόπος	ουσιαστικό	αρσενικό, ενικός, αιτιατική
τρίτο	τρίτος	επίθετο	αρσενικό, ενικός, αιτιατική
τρίτη	τρίτος	επίθετο	θηλυκό, ενικός, ονομαστική
πρέπει	πρέπει	 ρήμα	 απρόσωπο, ενεργητική, ενεστώτας, οριστική, ενικός, 3ο πρόσωπο
πράγμα	πράγμα	ουσιαστικό	ουδέτερο, ενικός, κλητική
τράγος	τράγος	ουσιαστικό	αρσενικό, ενικός, ονομαστική
κρυφά	κρυφός	επίθετο	ουδέτερο, πληθυντικός, αιτιατική
τρούλου	τρούλος	ουσιαστικό	αρσενικό, ενικός, γενική
πρώτος	πρώτος	επίθετο	αρσενικό, ενικός, ονομαστική
τρέφουν	τρέπω	ρήμα	ενεργητική, ενεστώτας, οριστική, πληθυντικός, 3ο πρόσωπο
τρούλους	τρούλος	ουσιαστικό	αρσενικό, πληθυντικός, αιτιατική
πρώτα	πρώτος	επίθετο	ουδέτερο, πληθυντικός, αιτιατική
πρώτη	πρώτος	επίθετο	θηλυκό, ενικός, ονομαστική
πρώτο	πρώτος	επίθετο	αρσενικό, ενικός, αιτιατική
πράξεις	πράξη	ουσιαστικό	θηλυκό, πληθυντικός, αιτιατική
κρίμα	κρίμα	ουσιαστικό	ουδέτερο, ενικός, κλητική
προχτές	προχτές	επίρρημα	
κριάρι	κριάρι	ουσιαστικό	ουδέτερο, ενικός, κλητική
τρέχει	τρέχω	ρήμα	ενεργητική, ενεστώτας, οριστική, ενικός, 3ο πρόσωπο
τρέχουν	τρέχω	ρήμα	ενεργητική, ενεστώτας, οριστική, πληθυντικός, 3ο πρόσωπο
τρόμος	τρόμος	ουσιαστικό	αρσενικό, ενικός, ονομαστική
τρίβει	τρίβω	ρήμα	ενεργητική, ενεστώτας, οριστική, ενικός, 3ο πρόσωπο
τριάντα	τριάντα	επίθετο	άκλιτο
τρελά	τρελός	επίθετο	ουδέτερο, πληθυντικός, αιτιατική
τρύπια	τρύπιος	επίθετο	θηλυκό, ενικός, ονομαστική
