ορμή	ορμή	ουσιαστικό	θηλυκό, ενικός, κλητική
ταξίδι	ταξίδι	ουσιαστικό	ουδέτερο, ενικός, κλητική
φανάρι	φανάρι	ουσιαστικό	ουδέτερο, ενικός, κλητική
βάθη	βάθος	ουσιαστικό	ουδέτερο, πληθυντικός, αιτιατική
ουρανού	ουρανός	ουσιαστικό	αρσενικό, ενικός, γενική
λιτότητα	λιτότητα	ουσιαστικό	θηλυκό, ενικός, κλητική
νερά	νερό	ουσιαστικό	ουδέτερο, πληθυντικός, αιτιατική
συγγενή	συγγενής	ουσιαστικό	αρσενικό, ενικός, κλητική
γης	γης	ουσιαστικό	άκλιτο
γράμμα	γράμμα	ουσιαστικό	ουδέτερο, ενικός, κλητική
κουκουβάγια	κουκουβάγια	ουσιαστικό	θηλυκό, ενικός, κλητική
βάζο	βάζο	ουσιαστικό	ουδέτερο, ενικός, κλητική
ζητά	ζητάς	ουσιαστικό	αρσενικό, ενικός, κλητική
αρετές	αρετή	ουσιαστικό	θηλυκό, πληθυντικός, αιτιατική
καιρός	καιρός	ουσιαστικό	αρσενικό, ενικός, ονομαστική
σκύλων	σκύλος	ουσιαστικό	αρσενικό, πληθυντικός, γενική
γύρους	γύρος	ουσιαστικό	αρσενικό, πληθυντικός, αιτιατική
ακρογιαλιά	ακρογιαλιά	ουσιαστικό	θηλυκό, ενικός, κλητική
πουλιά	πουλί	ουσιαστικό	ουδέτερο, πληθυντικός, αιτιατική
χιλιάδων	χιλιάδα	ουσιαστικό	θηλυκό, πληθυντικός, γενική
εκπρόσωπο	εκπρόσωπος	ουσιαστικό	αρσενικό, ενικός, αιτιατική
ποταμού	ποταμός	ουσιαστικό	αρσενικό, ενικός, γενική
ημίχρονο	ημίχρονο	ουσιαστικό	ουδέτερο, ενικός, κλητική
σταματημό	σταματημός	ουσιαστικό	αρσενικό, ενικός, αιτιατική
χιούμορ	χιούμορ	ουσιαστικό	άκλιτο
νερό	νερό	ουσιαστικό	ουδέτερο, ενικός, κλητική
μπράτσα	μπράτσο	ουσιαστικό	ουδέτερο, πληθυντικός, αιτιατική
νησιά	νησί	ουσιαστικό	ουδέτερο, πληθυντικός, αιτιατική
κατηγορίας	κατηγορία	ουσιαστικό	θηλυκό, ενικός, γενική
μπράτσο	μπράτσο	ουσιαστικό	ουδέτερο, ενικός, κλητική
ιουλίου	ιούλιος	ουσιαστικό	αρσενικό, ενικός, γενική
πουκάμισα	πουκάμισο	ουσιαστικό	ουδέτερο, πληθυντικός, αιτιατική
ηλιοθεραπεία	ηλιοθεραπεία	ουσιαστικό	θηλυκό, ενικός, κλητική
δρόμου	δρόμος	ουσιαστικό	αρσενικό, ενικός, γενική
ερευνητή	ερευνητής	ουσιαστικό	αρσενικό, ενικός, κλητική
μες	μες	ουσιαστικό	άκλιτο
γενιάς	γενιά	ουσιαστικό	θηλυκό, ενικός, γενική
σακί	σακί	ουσιαστικό	ουδέτερο, ενικός, κλητική
σκορ	σκορ	ουσιαστικό	άκλιτο
πανάγαθος	πανάγαθος	ουσιαστικό	αρσενικό, ενικός, ονομαστική
επεισοδίων	επεισόδιο	ουσιαστικό	ουδέτερο, πληθυντικός, γενική
αναφιλητά	αναφιλητό	ουσιαστικό	ουδέτερο, πληθυντικός, αιτιατική
πένθους	πένθος	ουσιαστικό	ουδέτερο, ενικός, γενική
πλάτη	πλάτη	ουσιαστικό	θηλυκό, ενικός, κλητική
ασφάλεια	ασφάλεια	ουσιαστικό	θηλυκό, ενικός, κλητική
φωνή	φωνή	ουσιαστικό	θηλυκό, ενικός, κλητική
πόρτας	πόρτα	ουσιαστικό	θηλυκό, ενικός, γενική
λουριά	λουρί	ουσιαστικό	ουδέτερο, πληθυντικός, αιτιατική
περιστατικά	περιστατικό	ουσιαστικό	ουδέτερο, πληθυντικός, αιτιατική
φιλί	φιλί	ουσιαστικό	ουδέτερο, ενικός, κλητική
συντάγματος	σύνταγμα	ουσιαστικό	ουδέτερο, ενικός, γενική
χάδια	χάδι	ουσιαστικό	ουδέτερο, πληθυντικός, αιτιατική
γηπέδου	γήπεδο	ουσιαστικό	ουδέτερο, ενικός, γενική
τούρκων	τούρκος	ουσιαστικό	αρσενικό, πληθυντικός, γενική
γόνατα	γόνατο	ουσιαστικό	ουδέτερο, πληθυντικός, αιτιατική
διαβάτες	διαβάτης	ουσιαστικό	αρσενικό, πληθυντικός, αιτιατική
δέντρου	δέντρο	ουσιαστικό	ουδέτερο, ενικός, γενική
πτερύγια	πτερύγιο	ουσιαστικό	ουδέτερο, πληθυντικός, αιτιατική
ταμείο	ταμείο	ουσιαστικό	ουδέτερο, ενικός, κλητική
αγελάδα	αγελάδα	ουσιαστικό	θηλυκό, ενικός, κλητική
προγιαγιάς	προγιαγιά	ουσιαστικό	θηλυκό, ενικός, γενική
λούσα	λούσο	ουσιαστικό	ουδέτερο, πληθυντικός, αιτιατική
άντρες	άντρας	ουσιαστικό	αρσενικό, πληθυντικός, αιτιατική
σκύλου	σκύλος	ουσιαστικό	αρσενικό, ενικός, γενική
σκύλος	σκύλος	ουσιαστικό	αρσενικό, ενικός, ονομαστική
βήματα	βήμα	ουσιαστικό	ουδέτερο, πληθυντικός, αιτιατική
κραυγές	κραυγή	ουσιαστικό	θηλυκό, πληθυντικός, αιτιατική
βήματα	βήμα	ουσιαστικό	ουδέτερο, πληθυντικός, αιτιατική
ικανοποίηση	ικανοποίηση	ουσιαστικό	θηλυκό, ενικός, κλητική
σκηνή	σκηνή	ουσιαστικό	θηλυκό, ενικός, κλητική
ουρανός	ουρανός	ουσιαστικό	αρσενικό, ενικός, ονομαστική
ένστικτο	ένστικτο	ουσιαστικό	ουδέτερο, ενικός, κλητική
μπαρμπα	μπάρμπας	ουσιαστικό	αρσενικό, ενικός, κλητική
λέξεις	λέξη	ουσιαστικό	θηλυκό, πληθυντικός, αιτιατική
ρεύματος	ρεύμα	ουσιαστικό	ουδέτερο, ενικός, γενική
κονσερβοκούτια	κονσερβοκούτι	ουσιαστικό	ουδέτερο, πληθυντικός, αιτιατική
τερματοφύλακες	τερματοφύλακας	ουσιαστικό	αρσενικό, πληθυντικός, αιτιατική
παλικάρι	παλικάρι	ουσιαστικό	ουδέτερο, ενικός, κλητική
επέτειο	επέτειος	ουσιαστικό	θηλυκό, ενικός, κλητική
απασχόληση	απασχόληση	ουσιαστικό	θηλυκό, ενικός, κλητική
δροσιά	δροσιά	ουσιαστικό	θηλυκό, ενικός, κλητική
οδυσσέα	οδυσσέας	ουσιαστικό	αρσενικό, ενικός, κλητική
σπιτι	σπίτι	ουσιαστικό	ουδέτερο, ενικός, κλητική
κοριτσιού	κορίτσι	ουσιαστικό	ουδέτερο, ενικός, γενική
χωράφι	χωράφι	ουσιαστικό	ουδέτερο, ενικός, κλητική
μέτρο	μέτρο	ουσιαστικό	ουδέτερο, ενικός, κλητική
άντρας	άντρας	ουσιαστικό	αρσενικό, ενικός, ονομαστική
ημερολογίου	ημερολόγιο	ουσιαστικό	ουδέτερο, ενικός, γενική
χαψιά	χαψιά	ουσιαστικό	θηλυκό, ενικός, κλητική
μέτρα	μέτρο	ουσιαστικό	ουδέτερο, πληθυντικός, αιτιατική
έρωτα	έρωτας	ουσιαστικό	αρσενικό, ενικός, κλητική
κρυψώνες	κρυψώνας	ουσιαστικό	αρσενικό, πληθυντικός, αιτιατική
νότο	νότος	ουσιαστικό	αρσενικό, ενικός, αιτιατική
ιδιαιτερότητες	ιδιαιτερότητα	ουσιαστικό	θηλυκό, πληθυντικός, αιτιατική
χελωνίτσες	χελωνίτσα	 ουσιαστικό	 θηλυκό, πληθυντικός, ονομαστική, αιτιατική, κλητική
απελπισία	απελπισία	ουσιαστικό	θηλυκό, ενικός, κλητική
ρυθμοί	ρυθμός	ουσιαστικό	αρσενικό, πληθυντικός, κλητική
σου	σου	ουσιαστικό	άκλιτο
χρώματα	χρώμα	ουσιαστικό	ουδέτερο, πληθυντικός, αιτιατική
πλεονεκτήματα	πλεονέκτημα	ουσιαστικό	ουδέτερο, πληθυντικός, αιτιατική
κτίρια	κτίριο	ουσιαστικό	ουδέτερο, πληθυντικός, αιτιατική
οχτρός	οχτρός	ουσιαστικό	αρσενικό, ενικός, ονομαστική
συμβόλαιο	συμβόλαιο	ουσιαστικό	ουδέτερο, ενικός, κλητική
μάνα	μάνα	ουσιαστικό	θηλυκό, ενικός, κλητική
χτύπημα	χτύπημα	ουσιαστικό	ουδέτερο, ενικός, κλητική
κάτοικοι	κάτοικος	ουσιαστικό	αρσενικό, πληθυντικός, κλητική
αυλές	αυλή	ουσιαστικό	θηλυκό, πληθυντικός, αιτιατική
μάθημα	μάθημα	ουσιαστικό	ουδέτερο, ενικός, κλητική
μάτι	μάτι	ουσιαστικό	ουδέτερο, ενικός, κλητική
αλλαγή	αλλαγή	ουσιαστικό	θηλυκό, ενικός, κλητική
μύτης	μύτη	ουσιαστικό	θηλυκό, ενικός, γενική
καρβέλι	καρβέλι	ουσιαστικό	ουδέτερο, ενικός, κλητική
αποθεώσεις	αποθέωση	ουσιαστικό	θηλυκό, πληθυντικός, αιτιατική
χαλίκια	χαλίκι	ουσιαστικό	ουδέτερο, πληθυντικός, αιτιατική
πόνου	πόνος	ουσιαστικό	αρσενικό, ενικός, γενική
αρχή	αρχές	ουσιαστικό	θηλυκό, ενικός, κλητική
κόρες	κόρη	ουσιαστικό	θηλυκό, πληθυντικός, αιτιατική
αρετή	αρετή	ουσιαστικό	θηλυκό, ενικός, κλητική
δικαίωμα	δικαίωμα	ουσιαστικό	ουδέτερο, ενικός, κλητική
σχολή	σχολή	ουσιαστικό	θηλυκό, ενικός, κλητική
συμμαθητές	συμμαθητής	ουσιαστικό	αρσενικό, πληθυντικός, αιτιατική
τρούλο	τρούλος	ουσιαστικό	αρσενικό, ενικός, αιτιατική
επιφάνεια	επιφάνεια	ουσιαστικό	θηλυκό, ενικός, κλητική
σκυλί	σκυλί	ουσιαστικό	ουδέτερο, ενικός, κλητική
πάντων	πάντες	ουσιαστικό	αρσενικό, πληθυντικός, γενική
εμπειρίες	εμπειρία	ουσιαστικό	θηλυκό, πληθυντικός, αιτιατική
στηθαίο	στηθαίο	ουσιαστικό	ουδέτερο, ενικός, κλητική
μπουμπουκιών	μπουμπούκι	ουσιαστικό	ουδέτερο, πληθυντικός, γενική
ζαμπόν	ζαμπόν	ουσιαστικό	άκλιτο
σειρά	σειρά	ουσιαστικό	θηλυκό, ενικός, κλητική
σκιά	σκιά	ουσιαστικό	θηλυκό, ενικός, κλητική
πλαγιά	πλαγιά	ουσιαστικό	θηλυκό, ενικός, κλητική
νεύρο	νεύρο	ουσιαστικό	ουδέτερο, ενικός, κλητική
ήλιος	ήλιος	ουσιαστικό	αρσενικό, ενικός, ονομαστική
σκουπιδιών	σκουπίδι	ουσιαστικό	ουδέτερο, πληθυντικός, γενική
άποψη	άποψη	ουσιαστικό	θηλυκό, ενικός, κλητική
συμβούλιο	συμβούλιο	ουσιαστικό	ουδέτερο, ενικός, κλητική
κατεύθυνση	κατεύθυνση	ουσιαστικό	θηλυκό, ενικός, κλητική
λίμνης	λίμνη	ουσιαστικό	θηλυκό, ενικός, γενική
ενθάρρυνση	ενθάρρυνση	ουσιαστικό	θηλυκό, ενικός, κλητική
βοηθών	βοηθός	ουσιαστικό	αρσενικό, πληθυντικός, γενική
σακούλες	σακούλα	ουσιαστικό	θηλυκό, πληθυντικός, αιτιατική
ήλιου	ήλιος	ουσιαστικό	αρσενικό, ενικός, γενική
εκκλησιά	εκκλησιά	ουσιαστικό	θηλυκό, ενικός, κλητική
φτερά	φτερό	ουσιαστικό	ουδέτερο, πληθυντικός, αιτιατική
ποτάμι	ποτάμι	ουσιαστικό	ουδέτερο, ενικός, κλητική
ημέρα	ημέρα	ουσιαστικό	θηλυκό, ενικός, κλητική
κλοτσιά	κλοτσιά	ουσιαστικό	θηλυκό, ενικός, κλητική
πρωταγωνιστές	πρωταγωνιστής	ουσιαστικό	αρσενικό, πληθυντικός, αιτιατική
ο	ο	ουσιαστικό	άκλιτο
μανούβρες	μανούβρα	ουσιαστικό	θηλυκό, πληθυντικός, αιτιατική
ε	ε	ουσιαστικό	άκλιτο
η	η	ουσιαστικό	άκλιτο
ταραχή	ταραχή	ουσιαστικό	θηλυκό, ενικός, κλητική
δάχτυλα	δάχτυλο	ουσιαστικό	ουδέτερο, πληθυντικός, αιτιατική
τύποι	τύπος	ουσιαστικό	αρσενικό, πληθυντικός, κλητική
προβλήματα	πρόβλημα	ουσιαστικό	ουδέτερο, πληθυντικός, αιτιατική
λεοπάρδαλη	λεοπάρδαλη	ουσιαστικό	θηλυκό, ενικός, κλητική
γείτονα	γείτονας	ουσιαστικό	αρσενικό, ενικός, κλητική
καφενείων	καφενείο	ουσιαστικό	ουδέτερο, πληθυντικός, γενική
μυθιστόρημα	μυθιστόρημα	ουσιαστικό	ουδέτερο, ενικός, κλητική
ταχύτητα	ταχύτητα	ουσιαστικό	θηλυκό, ενικός, κλητική
θύελλα	θύελλα	ουσιαστικό	θηλυκό, ενικός, κλητική
φανέλας	φανέλα	ουσιαστικό	θηλυκό, ενικός, γενική
μητέρα	μητέρα	ουσιαστικό	θηλυκό, ενικός, κλητική
φρενών	φρένες	ουσιαστικό	θηλυκό, πληθυντικός, γενική
εικόνες	εικόνα	ουσιαστικό	θηλυκό, πληθυντικός, αιτιατική
ακρίβειας	ακρίβεια	ουσιαστικό	θηλυκό, ενικός, γενική
ω	ω	ουσιαστικό	άκλιτο
ψέματα	ψέμα	ουσιαστικό	ουδέτερο, πληθυντικός, αιτιατική
όνομα	όνομα	ουσιαστικό	ουδέτερο, ενικός, κλητική
ματάκια	ματάκιας	ουσιαστικό	αρσενικό, ενικός, κλητική
πιτσιρικάς	πιτσιρικάς	ουσιαστικό	αρσενικό, ενικός, ονομαστική
αρετών	αρετή	ουσιαστικό	θηλυκό, πληθυντικός, γενική
κυρία	κυρία	ουσιαστικό	θηλυκό, ενικός, κλητική
μουσεία	μουσείο	ουσιαστικό	ουδέτερο, πληθυντικός, αιτιατική
πασά	πασάς	ουσιαστικό	αρσενικό, ενικός, κλητική
τρόπο	τρόπος	ουσιαστικό	αρσενικό, ενικός, αιτιατική
βουή	βουή	ουσιαστικό	θηλυκό, ενικός, κλητική
διάλογος	διάλογος	ουσιαστικό	αρσενικό, ενικός, ονομαστική
ρυθμός	ρυθμός	ουσιαστικό	αρσενικό, ενικός, ονομαστική
επίδραση	επίδραση	ουσιαστικό	θηλυκό, ενικός, κλητική
παπά	παπάς	ουσιαστικό	αρσενικό, ενικός, κλητική
μύτη	μύτη	ουσιαστικό	θηλυκό, ενικός, κλητική
διαμαρτυριών	διαμαρτυρία	ουσιαστικό	θηλυκό, πληθυντικός, γενική
στολή	στολή	ουσιαστικό	θηλυκό, ενικός, κλητική
παρά	παράς	ουσιαστικό	αρσενικό, ενικός, κλητική
ταξιάρχες	ταξιάρχης	ουσιαστικό	αρσενικό, πληθυντικός, αιτιατική
παπα	πάπας	ουσιαστικό	αρσενικό, ενικός, κλητική
λόγο	λόγος	ουσιαστικό	αρσενικό, ενικός, αιτιατική
απόχρωση	απόχρωση	ουσιαστικό	θηλυκό, ενικός, κλητική
άδικα	άδικο	ουσιαστικό	ουδέτερο, πληθυντικός, αιτιατική
ημερολόγιο	ημερολόγιο	ουσιαστικό	ουδέτερο, ενικός, κλητική
φαντασία	φαντασία	ουσιαστικό	θηλυκό, ενικός, κλητική
συμπεριφορές	συμπεριφορά	ουσιαστικό	θηλυκό, πληθυντικός, αιτιατική
ψαράδες	ψαράς	ουσιαστικό	αρσενικό, πληθυντικός, αιτιατική
αυλάκια	αυλάκι	ουσιαστικό	ουδέτερο, πληθυντικός, αιτιατική
δάγκωμα	δάγκωμα	ουσιαστικό	ουδέτερο, ενικός, κλητική
ιδιοτροπία	ιδιοτροπία	ουσιαστικό	θηλυκό, ενικός, κλητική
λυγμούς	λυγμός	ουσιαστικό	αρσενικό, πληθυντικός, αιτιατική
μισοφέγγαρα	μισοφέγγαρο	ουσιαστικό	ουδέτερο, πληθυντικός, αιτιατική
γρασίδι	γρασίδι	ουσιαστικό	ουδέτερο, ενικός, κλητική
τύχη	τύχη	ουσιαστικό	θηλυκό, ενικός, κλητική
ακρίβεια	ακρίβεια	ουσιαστικό	θηλυκό, ενικός, κλητική
οικισμού	οικισμός	ουσιαστικό	αρσενικό, ενικός, γενική
απομεσήμερο	απομεσήμερο	ουσιαστικό	ουδέτερο, ενικός, κλητική
βοηθός	βοηθός	ουσιαστικό	αρσενικό, ενικός, ονομαστική
ύφαλα	ύφαλα	ουσιαστικό	ουδέτερο, πληθυντικός, αιτιατική
ημερολόγιο	ημερολόγιο	ουσιαστικό	ουδέτερο, ενικός, κλητική
νύχτα	νύχτα	ουσιαστικό	θηλυκό, ενικός, κλητική
πλατεία	πλατεία	ουσιαστικό	θηλυκό, ενικός, κλητική
λόφους	λόφος	ουσιαστικό	αρσενικό, πληθυντικός, αιτιατική
χαμός	χαμός	ουσιαστικό	αρσενικό, ενικός, ονομαστική
λάδι	λάδι	ουσιαστικό	ουδέτερο, ενικός, κλητική
τζαμί	τζαμί	ουσιαστικό	ουδέτερο, ενικός, κλητική
προελεύσεως	προέλευση	ουσιαστικό	θηλυκό, ενικός, γενική
μύλο	μύλος	ουσιαστικό	αρσενικό, ενικός, αιτιατική
ευχή	ευχή	ουσιαστικό	θηλυκό, ενικός, κλητική
άσφαλτο	άσφαλτος	ουσιαστικό	αρσενικό, ενικός, αιτιατική
κινήσεις	κίνηση	ουσιαστικό	θηλυκό, πληθυντικός, αιτιατική
σπάσιμο	σπάσιμο	ουσιαστικό	ουδέτερο, ενικός, κλητική
κόσμου	κόσμος	ουσιαστικό	αρσενικό, ενικός, γενική
βαριά	βαριά	ουσιαστικό	θηλυκό, ενικός, κλητική
κόσμος	κόσμος	ουσιαστικό	αρσενικό, ενικός, ονομαστική
πανταλόνι	πανταλόνι	ουσιαστικό	ουδέτερο, ενικός, κλητική
ανασήκωμα	ανασήκωμα	ουσιαστικό	ουδέτερο, ενικός, κλητική
πέρασμα	πέρασμα	ουσιαστικό	ουδέτερο, ενικός, κλητική
κοσμάκη	κοσμάκης	ουσιαστικό	αρσενικό, ενικός, κλητική
είδηση	είδηση	ουσιαστικό	θηλυκό, ενικός, κλητική
βράχους	βράχος	ουσιαστικό	αρσενικό, πληθυντικός, αιτιατική
ρυθμού	ρυθμός	ουσιαστικό	αρσενικό, ενικός, γενική
παραμύθι	παραμύθι	ουσιαστικό	ουδέτερο, ενικός, κλητική
εκπρόσωπος	εκπρόσωπος	ουσιαστικό	αρσενικό, ενικός, ονομαστική
δυνάμεις	δυνάμεις	ουσιαστικό	θηλυκό, πληθυντικός, αιτιατική
ήρωα	ήρωας	ουσιαστικό	αρσενικό, ενικός, κλητική
προκοπή	προκοπή	ουσιαστικό	θηλυκό, ενικός, κλητική
θεματολογία	θεματολογία	ουσιαστικό	θηλυκό, ενικός, κλητική
δικαιοσύνη	δικαιοσύνη	ουσιαστικό	θηλυκό, ενικός, κλητική
παζάρια	παζάρι	ουσιαστικό	ουδέτερο, πληθυντικός, αιτιατική
μαρτυρίου	μαρτύριο	ουσιαστικό	ουδέτερο, ενικός, γενική
ζυμάρι	ζυμάρι	ουσιαστικό	ουδέτερο, ενικός, κλητική
υπερρεαλιστής	υπερρεαλιστής	ουσιαστικό	αρσενικό, ενικός, ονομαστική
σώματα	σώμα	ουσιαστικό	ουδέτερο, πληθυντικός, αιτιατική
θεάτρου	θέατρο	ουσιαστικό	ουδέτερο, ενικός, γενική
λεφτά	λεφτάς	ουσιαστικό	αρσενικό, ενικός, κλητική
παίχτη	παίχτης	ουσιαστικό	αρσενικό, ενικός, κλητική
χρυσάφι	χρυσάφι	ουσιαστικό	ουδέτερο, ενικός, κλητική
φάλαινα	φάλαινα	ουσιαστικό	θηλυκό, ενικός, κλητική
αστραπή	αστραπή	ουσιαστικό	θηλυκό, ενικός, κλητική
βήξιμο	βήξιμο	ουσιαστικό	ουδέτερο, ενικός, κλητική
κολυμβητής	κολυμβητής	ουσιαστικό	αρσενικό, ενικός, ονομαστική
πύργους	πύργος	ουσιαστικό	αρσενικό, πληθυντικός, αιτιατική
αγάπη	αγάπη	ουσιαστικό	θηλυκό, ενικός, κλητική
τερματοφύλακας	τερματοφύλακας	ουσιαστικό	αρσενικό, ενικός, ονομαστική
συνθήκες	συνθήκη	ουσιαστικό	θηλυκό, πληθυντικός, αιτιατική
φανάρια	φανάρι	ουσιαστικό	ουδέτερο, πληθυντικός, αιτιατική
μέρα	μέρα	ουσιαστικό	θηλυκό, ενικός, κλητική
ευαγγελίου	ευαγγέλιο	ουσιαστικό	ουδέτερο, ενικός, γενική
παπούτσια	παπούτσι	ουσιαστικό	ουδέτερο, πληθυντικός, αιτιατική
πόδια	πόδι	ουσιαστικό	ουδέτερο, πληθυντικός, αιτιατική
όχθης	όχθη	ουσιαστικό	θηλυκό, ενικός, γενική
λαιμό	λαιμά	ουσιαστικό	ουδέτερο, ενικός, κλητική
προσοχή	προσοχή	ουσιαστικό	θηλυκό, ενικός, κλητική
καλά	καλό	ουσιαστικό	ουδέτερο, πληθυντικός, αιτιατική
χώμα	χώμα	ουσιαστικό	ουδέτερο, ενικός, κλητική
κυνηγό	κυνηγός	ουσιαστικό	αρσενικό, ενικός, αιτιατική
πέσιμο	πέσιμο	ουσιαστικό	ουδέτερο, ενικός, κλητική
καραγκιόζης	καραγκιόζης	ουσιαστικό	αρσενικό, ενικός, ονομαστική
οκνηρία	οκνηρία	ουσιαστικό	θηλυκό, ενικός, κλητική
καλό	καλό	ουσιαστικό	ουδέτερο, ενικός, κλητική
φόρεμα	φόρεμα	ουσιαστικό	ουδέτερο, ενικός, κλητική
κέδρα	κέδρο	ουσιαστικό	ουδέτερο, πληθυντικός, αιτιατική
καρποφορία	καρποφορία	ουσιαστικό	θηλυκό, ενικός, κλητική
δείγμα	δείγμα	ουσιαστικό	ουδέτερο, ενικός, κλητική
λόφο	λόφος	ουσιαστικό	αρσενικό, ενικός, αιτιατική
τρυφερότητα	τρυφερότητα	ουσιαστικό	θηλυκό, ενικός, κλητική
στοργή	στοργή	ουσιαστικό	θηλυκό, ενικός, κλητική
προαύλιο	προαύλιο	ουσιαστικό	ουδέτερο, ενικός, κλητική
σωτήρας	σωτήρας	ουσιαστικό	αρσενικό, ενικός, ονομαστική
στέφανος	στέφανος	ουσιαστικό	αρσενικό, ενικός, ονομαστική
γιορτής	γιορτή	ουσιαστικό	θηλυκό, ενικός, γενική
σύμπλεγμα	σύμπλεγμα	ουσιαστικό	ουδέτερο, ενικός, κλητική
χρώμα	χρώμα	ουσιαστικό	ουδέτερο, ενικός, κλητική
αδέλφια	αδέλφι	ουσιαστικό	ουδέτερο, πληθυντικός, αιτιατική
παγωτά	παγωτό	ουσιαστικό	ουδέτερο, πληθυντικός, αιτιατική
βλάστηση	βλάστηση	ουσιαστικό	θηλυκό, ενικός, κλητική
τέρματος	τέρμα	ουσιαστικό	ουδέτερο, ενικός, γενική
παγωτό	παγωτό	ουσιαστικό	ουδέτερο, ενικός, κλητική
χαρακτήρα	χαρακτήρας	ουσιαστικό	αρσενικό, ενικός, κλητική
ερειπίου	ερείπιο	ουσιαστικό	ουδέτερο, ενικός, γενική
φήμη	φήμη	ουσιαστικό	θηλυκό, ενικός, κλητική
ανθρώπους	άνθρωπος	ουσιαστικό	αρσενικό, πληθυντικός, αιτιατική
ανέμου	άνεμος	ουσιαστικό	αρσενικό, ενικός, γενική
σφοδρότητα	σφοδρότητα	ουσιαστικό	θηλυκό, ενικός, κλητική
παρακόρες	παρακόρη	ουσιαστικό	θηλυκό, πληθυντικός, αιτιατική
τόπος	τόπος	ουσιαστικό	αρσενικό, ενικός, ονομαστική
πράγμα	πράγμα	ουσιαστικό	ουδέτερο, ενικός, κλητική
σαράι	σαράι	ουσιαστικό	ουδέτερο, ενικός, κλητική
αστερισμό	αστερισμός	ουσιαστικό	αρσενικό, ενικός, αιτιατική
άνθρωποι	άνθρωπος	ουσιαστικό	αρσενικό, πληθυντικός, κλητική
τόποι	τόπος	ουσιαστικό	αρσενικό, πληθυντικός, κλητική
ιστορίας	ιστορία	ουσιαστικό	θηλυκό, ενικός, γενική
μου	μου	ουσιαστικό	άκλιτο
μύλος	μύλος	ουσιαστικό	αρσενικό, ενικός, ονομαστική
ημερα	ημέρα	ουσιαστικό	θηλυκό, ενικός, κλητική
κόκαλο	κόκαλο	ουσιαστικό	ουδέτερο, ενικός, κλητική
βόλτες	βόλτα	ουσιαστικό	θηλυκό, πληθυντικός, αιτιατική
αλεπού	αλεπός	ουσιαστικό	αρσενικό, ενικός, γενική
δίπλα	δίπλα	ουσιαστικό	θηλυκό, ενικός, κλητική
σώματος	σώμα	ουσιαστικό	ουδέτερο, ενικός, γενική
αφετηρία	αφετηρία	ουσιαστικό	θηλυκό, ενικός, κλητική
κόκαλα	κόκαλο	ουσιαστικό	ουδέτερο, πληθυντικός, αιτιατική
κομμάτι	κομμάτι	ουσιαστικό	ουδέτερο, ενικός, κλητική
πραγματικότητα	πραγματικότητα	ουσιαστικό	θηλυκό, ενικός, κλητική
παππούς	παππούς	ουσιαστικό	αρσενικό, ενικός, ονομαστική
χαράματα	χάραμα	ουσιαστικό	ουδέτερο, πληθυντικός, αιτιατική
τράγος	τράγος	ουσιαστικό	αρσενικό, ενικός, ονομαστική
αέρα	αέρας	ουσιαστικό	αρσενικό, ενικός, κλητική
πατριώτης	πατριώτης	ουσιαστικό	αρσενικό, ενικός, ονομαστική
συνήθεια	συνήθειο	ουσιαστικό	ουδέτερο, πληθυντικός, αιτιατική
περιεχόμενο	περιεχόμενο	ουσιαστικό	ουδέτερο, ενικός, κλητική
ανωμαλίες	ανωμαλία	ουσιαστικό	θηλυκό, πληθυντικός, αιτιατική
σκέψη	σκέψη	ουσιαστικό	θηλυκό, ενικός, κλητική
κυράς	κυρά	ουσιαστικό	θηλυκό, ενικός, γενική
παιδιού	παιδί	ουσιαστικό	ουδέτερο, ενικός, γενική
παραλία	παραλία	ουσιαστικό	θηλυκό, ενικός, κλητική
σκοτούρες	σκοτούρα	ουσιαστικό	θηλυκό, πληθυντικός, αιτιατική
ιστορίες	ιστορία	ουσιαστικό	θηλυκό, πληθυντικός, αιτιατική
ήλιο	ήλιο	ουσιαστικό	ουδέτερο, ενικός, κλητική
θέμα	θέμα	ουσιαστικό	ουδέτερο, ενικός, κλητική
τρούλου	τρούλος	ουσιαστικό	αρσενικό, ενικός, γενική
αρχηγούς	αρχηγός	ουσιαστικό	αρσενικό, πληθυντικός, αιτιατική
νάιλον	νάιλον	ουσιαστικό	άκλιτο
τύχη	τύχη	ουσιαστικό	θηλυκό, ενικός, κλητική
ανατολής	ανατολή	ουσιαστικό	θηλυκό, ενικός, γενική
επίθετα	επίθετο	ουσιαστικό	ουδέτερο, πληθυντικός, αιτιατική
ανηφοροκατήφορο	ανηφοροκατήφορος	ουσιαστικό	αρσενικό, ενικός, αιτιατική
διαιτητής	διαιτητής	ουσιαστικό	αρσενικό, ενικός, ονομαστική
λιοπύρι	λιοπύρι	ουσιαστικό	ουδέτερο, ενικός, κλητική
στεριά	στεριά	ουσιαστικό	θηλυκό, ενικός, κλητική
επίθεση	επίθεση	ουσιαστικό	θηλυκό, ενικός, κλητική
πρόθεση	πρόθεση	ουσιαστικό	θηλυκό, ενικός, κλητική
κήπο	κήπος	ουσιαστικό	αρσενικό, ενικός, αιτιατική
κρεβάτι	κρεβάτι	ουσιαστικό	ουδέτερο, ενικός, κλητική
σπόρια	σπόρι	ουσιαστικό	ουδέτερο, πληθυντικός, αιτιατική
ρήση	ρήση	ουσιαστικό	θηλυκό, ενικός, κλητική
προβολείς	προβολέας	ουσιαστικό	αρσενικό, πληθυντικός, αιτιατική
αγκαλιά	αγκαλιά	ουσιαστικό	θηλυκό, ενικός, κλητική
ρυθμό	ρυθμός	ουσιαστικό	αρσενικό, ενικός, αιτιατική
άρτε	άρτος	ουσιαστικό	αρσενικό, ενικός, κλητική
θρόισμα	θρόισμα	ουσιαστικό	ουδέτερο, ενικός, κλητική
δίνη	δίνη	ουσιαστικό	θηλυκό, ενικός, κλητική
παιδιών	παιδί	ουσιαστικό	ουδέτερο, πληθυντικός, γενική
ψωμιού	ψωμί	ουσιαστικό	ουδέτερο, ενικός, γενική
βάρκα	βάρκα	ουσιαστικό	θηλυκό, ενικός, κλητική
σχολειό	σχολειό	ουσιαστικό	ουδέτερο, ενικός, κλητική
συμπεριφορά	συμπεριφορά	ουσιαστικό	θηλυκό, ενικός, κλητική
τύπο	τύπος	ουσιαστικό	αρσενικό, ενικός, αιτιατική
σέντρα	σέντρα	ουσιαστικό	θηλυκό, ενικός, κλητική
αρχηγοί	αρχηγός	ουσιαστικό	αρσενικό, πληθυντικός, κλητική
ορίζοντα	ορίζοντας	ουσιαστικό	αρσενικό, ενικός, κλητική
ειρήνη	ειρήνη	ουσιαστικό	θηλυκό, ενικός, κλητική
ομάδες	ομάδα	ουσιαστικό	θηλυκό, πληθυντικός, αιτιατική
νερών	νερό	ουσιαστικό	ουδέτερο, πληθυντικός, γενική
δίχτυα	δίχτυ	ουσιαστικό	ουδέτερο, πληθυντικός, αιτιατική
μπριζόλες	μπριζόλα	ουσιαστικό	θηλυκό, πληθυντικός, αιτιατική
αύρα	αύρα	ουσιαστικό	θηλυκό, ενικός, κλητική
ταύρος	ταύρος	ουσιαστικό	αρσενικό, ενικός, ονομαστική
ταύρου	ταύρος	ουσιαστικό	αρσενικό, ενικός, γενική
μέλημα	μέλημα	ουσιαστικό	ουδέτερο, ενικός, κλητική
ιούνη	ιούνης	ουσιαστικό	αρσενικό, ενικός, κλητική
ταξιδιώτη	ταξιδιώτης	ουσιαστικό	αρσενικό, ενικός, κλητική
απόγευμα	απόγευμα	ουσιαστικό	ουδέτερο, ενικός, κλητική
παραθεριστές	παραθεριστής	ουσιαστικό	αρσενικό, πληθυντικός, αιτιατική
λόφοι	λόφος	ουσιαστικό	αρσενικό, πληθυντικός, κλητική
επιτυχία	επιτυχία	ουσιαστικό	θηλυκό, ενικός, κλητική
απόσταση	απόσταση	ουσιαστικό	θηλυκό, ενικός, κλητική
στιγμή	στιγμή	ουσιαστικό	θηλυκό, ενικός, κλητική
γυναίκας	γυναίκα	ουσιαστικό	θηλυκό, ενικός, γενική
σκουμπρί	σκουμπρί	ουσιαστικό	ουδέτερο, ενικός, κλητική
γυναικών	γυναίκα	ουσιαστικό	θηλυκό, πληθυντικός, γενική
ώμο	ώμος	ουσιαστικό	αρσενικό, ενικός, αιτιατική
προγιαγιά	προγιαγιά	ουσιαστικό	θηλυκό, ενικός, κλητική
πύλη	πύλη	ουσιαστικό	θηλυκό, ενικός, κλητική
καλύβα	καλύβα	ουσιαστικό	θηλυκό, ενικός, κλητική
μάχης	μάχη	ουσιαστικό	θηλυκό, ενικός, γενική
πολέμου	πόλεμος	ουσιαστικό	αρσενικό, ενικός, γενική
άντρα	άντρας	ουσιαστικό	αρσενικό, ενικός, κλητική
ομάδας	ομάδα	ουσιαστικό	θηλυκό, ενικός, γενική
οικογένειας	οικογένεια	ουσιαστικό	θηλυκό, ενικός, γενική
θάρρος	θάρρος	ουσιαστικό	ουδέτερο, ενικός, κλητική
συζήτηση	συζήτηση	ουσιαστικό	θηλυκό, ενικός, κλητική
δάσκαλος	δάσκαλος	ουσιαστικό	αρσενικό, ενικός, ονομαστική
αστέρια	αστέρι	ουσιαστικό	ουδέτερο, πληθυντικός, αιτιατική
δώρο	δώρο	ουσιαστικό	ουδέτερο, ενικός, κλητική
θυγατέρων	θυγατέρα	ουσιαστικό	θηλυκό, πληθυντικός, γενική
μίλια	μίλι	ουσιαστικό	ουδέτερο, πληθυντικός, αιτιατική
νηστεία	νηστεία	ουσιαστικό	θηλυκό, ενικός, κλητική
θάμνους	θάμνος	ουσιαστικό	αρσενικό, πληθυντικός, αιτιατική
δράση	δράση	ουσιαστικό	θηλυκό, ενικός, κλητική
κοιλιά	κοιλιά	ουσιαστικό	θηλυκό, ενικός, κλητική
στρατοκόποι	στρατοκόπος	ουσιαστικό	αρσενικό, πληθυντικός, κλητική
δίας	δίας	ουσιαστικό	αρσενικό, ενικός, ονομαστική
χειλιών	χείλι	ουσιαστικό	ουδέτερο, πληθυντικός, γενική
πλήθη	πλήθος	ουσιαστικό	ουδέτερο, πληθυντικός, αιτιατική
πιοτό	πιοτό	ουσιαστικό	ουδέτερο, ενικός, κλητική
ηλιαχτίδες	ηλιαχτίδα	ουσιαστικό	θηλυκό, πληθυντικός, αιτιατική
γλύκας	γλύκα	ουσιαστικό	θηλυκό, ενικός, γενική
μανία	μανία	ουσιαστικό	θηλυκό, ενικός, κλητική
χελώνα	χελώνα	ουσιαστικό	θηλυκό, ενικός, κλητική
σχολείο	σχολείο	ουσιαστικό	ουδέτερο, ενικός, κλητική
καταυλισμούς	καταυλισμός	ουσιαστικό	αρσενικό, πληθυντικός, αιτιατική
σχέση	σχέση	ουσιαστικό	θηλυκό, ενικός, κλητική
ρακέτες	ρακέτα	ουσιαστικό	θηλυκό, πληθυντικός, αιτιατική
παραστάσεως	παράσταση	ουσιαστικό	θηλυκό, ενικός, γενική
ακτή	ακτή	ουσιαστικό	θηλυκό, ενικός, κλητική
κόσμο	κόσμος	ουσιαστικό	αρσενικό, ενικός, αιτιατική
αφρούς	αφρός	ουσιαστικό	αρσενικό, πληθυντικός, αιτιατική
ειδών	είδος	ουσιαστικό	ουδέτερο, πληθυντικός, γενική
κάστρο	κάστρο	ουσιαστικό	ουδέτερο, ενικός, κλητική
ζάχαρη	ζάχαρη	ουσιαστικό	θηλυκό, ενικός, κλητική
πόλης	πόλη	ουσιαστικό	θηλυκό, ενικός, γενική
θερμοκρασία	θερμοκρασία	ουσιαστικό	θηλυκό, ενικός, κλητική
κουτιά	κουτί	ουσιαστικό	ουδέτερο, πληθυντικός, αιτιατική
σκαλοπάτι	σκαλοπάτι	ουσιαστικό	ουδέτερο, ενικός, κλητική
κεφάλι	κεφάλι	ουσιαστικό	ουδέτερο, ενικός, κλητική
καταστάσεις	κατάσταση	ουσιαστικό	θηλυκό, πληθυντικός, αιτιατική
οδυσσέας	οδυσσέας	ουσιαστικό	αρσενικό, ενικός, ονομαστική
τρούλους	τρούλος	ουσιαστικό	αρσενικό, πληθυντικός, αιτιατική
χορό	χορός	ουσιαστικό	αρσενικό, ενικός, αιτιατική
ποτήρι	ποτήρι	ουσιαστικό	ουδέτερο, ενικός, κλητική
συνεταίροι	συνέταιρος	ουσιαστικό	αρσενικό, πληθυντικός, κλητική
πληγή	πληγή	ουσιαστικό	θηλυκό, ενικός, κλητική
παρατηρητή	παρατηρητής	ουσιαστικό	αρσενικό, ενικός, κλητική
βράδυ	βράδυ	ουσιαστικό	ουδέτερο, ενικός, κλητική
θαυμάτων	θαύμα	ουσιαστικό	ουδέτερο, πληθυντικός, γενική
καραγκιόζη	καραγκιόζης	ουσιαστικό	αρσενικό, ενικός, κλητική
θέατρο	θέατρο	ουσιαστικό	ουδέτερο, ενικός, κλητική
πράξεις	πράξη	ουσιαστικό	θηλυκό, πληθυντικός, αιτιατική
σκάφη	σκάφη	ουσιαστικό	θηλυκό, ενικός, κλητική
φωνές	φωνή	ουσιαστικό	θηλυκό, πληθυντικός, αιτιατική
τέλη	τέλος	ουσιαστικό	ουδέτερο, πληθυντικός, αιτιατική
εκτίμηση	εκτίμηση	ουσιαστικό	θηλυκό, ενικός, κλητική
πτώση	πτώση	ουσιαστικό	θηλυκό, ενικός, κλητική
πεδίο	πεδίο	ουσιαστικό	ουδέτερο, ενικός, κλητική
ταυρομαχίες	ταυρομαχία	ουσιαστικό	θηλυκό, πληθυντικός, αιτιατική
σημασία	σημασία	ουσιαστικό	θηλυκό, ενικός, κλητική
άνοιγμα	άνοιγμα	ουσιαστικό	ουδέτερο, ενικός, κλητική
άνοιγμα	άνοιγμα	ουσιαστικό	ουδέτερο, ενικός, κλητική
οπλές	οπλή	ουσιαστικό	θηλυκό, πληθυντικός, αιτιατική
καταρράχτες	καταρράχτης	ουσιαστικό	αρσενικό, πληθυντικός, αιτιατική
παραστάσεις	παράσταση	ουσιαστικό	θηλυκό, πληθυντικός, αιτιατική
αφήγησης	αφήγηση	ουσιαστικό	θηλυκό, ενικός, γενική
εφημερίδες	εφημερίδα	ουσιαστικό	θηλυκό, πληθυντικός, αιτιατική
κονσερβοκούτι	κονσερβοκούτι	ουσιαστικό	ουδέτερο, ενικός, κλητική
σκοινιού	σκοινί	ουσιαστικό	ουδέτερο, ενικός, γενική
ρεπερτόριο	ρεπερτόριο	ουσιαστικό	ουδέτερο, ενικός, κλητική
συνομοταξία	συνομοταξία	ουσιαστικό	θηλυκό, ενικός, κλητική
σημάδια	σημάδι	ουσιαστικό	ουδέτερο, πληθυντικός, αιτιατική
τσίγκο	τσίγκος	ουσιαστικό	αρσενικό, ενικός, αιτιατική
γύρο	γύρος	ουσιαστικό	αρσενικό, ενικός, αιτιατική
παραλία	παραλία	ουσιαστικό	θηλυκό, ενικός, κλητική
εφοπλιστής	εφοπλιστής	ουσιαστικό	αρσενικό, ενικός, ονομαστική
κατηγορία	κατηγορία	ουσιαστικό	θηλυκό, ενικός, κλητική
διατήρηση	διατήρηση	ουσιαστικό	θηλυκό, ενικός, κλητική
κρίμα	κρίμα	ουσιαστικό	ουδέτερο, ενικός, κλητική
λαού	λαός	ουσιαστικό	αρσενικό, ενικός, γενική
διάλογο	διάλογος	ουσιαστικό	αρσενικό, ενικός, αιτιατική
ύστερα	ύστερο	ουσιαστικό	ουδέτερο, πληθυντικός, αιτιατική
σχέσεις	σχέση	ουσιαστικό	θηλυκό, πληθυντικός, αιτιατική
μητέρα	μητέρα	ουσιαστικό	θηλυκό, ενικός, κλητική
τενεκέ	τενεκές	ουσιαστικό	αρσενικό, ενικός, κλητική
καταρράχτη	καταρράχτης	ουσιαστικό	αρσενικό, ενικός, κλητική
βία	βία	ουσιαστικό	θηλυκό, ενικός, κλητική
κομπάρσοι	κομπάρσος	ουσιαστικό	αρσενικό, πληθυντικός, κλητική
λιώμα	λιώμα	ουσιαστικό	ουδέτερο, ενικός, κλητική
γκαρσόνι	γκαρσόνι	ουσιαστικό	ουδέτερο, ενικός, κλητική
οθόνης	οθόνη	ουσιαστικό	θηλυκό, ενικός, γενική
θυγατέρα	θυγατέρα	ουσιαστικό	θηλυκό, ενικός, κλητική
κήτος	κήτος	ουσιαστικό	ουδέτερο, ενικός, κλητική
μαχαίρι	μαχαίρι	ουσιαστικό	ουδέτερο, ενικός, κλητική
ακμής	ακμή	ουσιαστικό	θηλυκό, ενικός, γενική
γλάστρες	γλάστρα	ουσιαστικό	θηλυκό, πληθυντικός, αιτιατική
γονείς	γονέας	ουσιαστικό	αρσενικό, πληθυντικός, αιτιατική
υπαιτιότητα	υπαιτιότητα	ουσιαστικό	θηλυκό, ενικός, κλητική
τιμωρία	τιμωρία	ουσιαστικό	θηλυκό, ενικός, κλητική
κορφή	κορφή	ουσιαστικό	θηλυκό, ενικός, κλητική
λαό	λαός	ουσιαστικό	αρσενικό, ενικός, αιτιατική
κοιλάδα	κοιλάδα	ουσιαστικό	θηλυκό, ενικός, κλητική
άνεμος	άνεμος	ουσιαστικό	αρσενικό, ενικός, ονομαστική
απόρριψη	απόρριψη	ουσιαστικό	θηλυκό, ενικός, κλητική
μηχανή	μηχανή	ουσιαστικό	θηλυκό, ενικός, κλητική
σύρραξη	σύρραξη	ουσιαστικό	θηλυκό, ενικός, κλητική
φουκαράδες	φουκαράς	ουσιαστικό	αρσενικό, πληθυντικός, αιτιατική
ρινόκερος	ρινόκερος	ουσιαστικό	αρσενικό, ενικός, ονομαστική
βασιλιά	βασιλιάς	ουσιαστικό	αρσενικό, ενικός, κλητική
ταυρομάχος	ταυρομάχος	ουσιαστικό	αρσενικό, ενικός, ονομαστική
ταυρομάχου	ταυρομάχος	ουσιαστικό	αρσενικό, ενικός, γενική
κυκλάμινο	κυκλάμινο	ουσιαστικό	ουδέτερο, ενικός, κλητική
σάββατο	σάββατο	ουσιαστικό	ουδέτερο, ενικός, κλητική
σκοινί	σκοινί	ουσιαστικό	ουδέτερο, ενικός, κλητική
δέσμες	δέσμη	ουσιαστικό	θηλυκό, πληθυντικός, αιτιατική
λιμάνι	λιμάνι	ουσιαστικό	ουδέτερο, ενικός, κλητική
δραστηριότητα	δραστηριότητα	ουσιαστικό	θηλυκό, ενικός, κλητική
πολυθρόνες	πολυθρόνα	ουσιαστικό	θηλυκό, πληθυντικός, αιτιατική
βότσαλα	βότσαλο	ουσιαστικό	ουδέτερο, πληθυντικός, αιτιατική
μερίδα	μερίδα	ουσιαστικό	θηλυκό, ενικός, κλητική
μαλλιά	μαλλί	ουσιαστικό	ουδέτερο, πληθυντικός, αιτιατική
γειτονιάς	γειτονιά	ουσιαστικό	θηλυκό, ενικός, γενική
ιδέες	ιδέα	ουσιαστικό	θηλυκό, πληθυντικός, αιτιατική
ανταλλαγή	ανταλλαγή	ουσιαστικό	θηλυκό, ενικός, κλητική
απάντηση	απάντηση	ουσιαστικό	θηλυκό, ενικός, κλητική
ονόματα	όνομα	ουσιαστικό	ουδέτερο, πληθυντικός, αιτιατική
θόλος	θόλος	ουσιαστικό	θηλυκό, ενικός, ονομαστική
γειτονιές	γειτονιά	ουσιαστικό	θηλυκό, πληθυντικός, αιτιατική
ματιά	ματιά	ουσιαστικό	θηλυκό, ενικός, κλητική
συζητήσεις	συζήτηση	ουσιαστικό	θηλυκό, πληθυντικός, αιτιατική
βράχο	βράχος	ουσιαστικό	αρσενικό, ενικός, αιτιατική
στάσεις	στάση	ουσιαστικό	θηλυκό, πληθυντικός, αιτιατική
σφυριά	σφυρί	ουσιαστικό	ουδέτερο, πληθυντικός, αιτιατική
ακρογιάλι	ακρογιάλι	ουσιαστικό	ουδέτερο, ενικός, κλητική
γάβγισμα	γάβγισμα	ουσιαστικό	ουδέτερο, ενικός, κλητική
δάσκαλο	δάσκαλος	ουσιαστικό	αρσενικό, ενικός, αιτιατική
γυναίκα	γυναίκα	ουσιαστικό	θηλυκό, ενικός, κλητική
γιαγιά	γιαγιά	ουσιαστικό	θηλυκό, ενικός, κλητική
δισεκατομμυριούχος	δισεκατομμυριούχος	ουσιαστικό	θηλυκό, ενικός, ονομαστική
νοεμβρίου	νοέμβριος	ουσιαστικό	αρσενικό, ενικός, γενική
ύφος	ύφος	ουσιαστικό	ουδέτερο, ενικός, κλητική
απελπισίας	απελπισία	ουσιαστικό	θηλυκό, ενικός, γενική
εγκατάστασης	εγκατάσταση	ουσιαστικό	θηλυκό, ενικός, γενική
κορίτσια	κορίτσι	ουσιαστικό	ουδέτερο, πληθυντικός, αιτιατική
εκκλησιές	εκκλησιά	ουσιαστικό	θηλυκό, πληθυντικός, αιτιατική
πλαγιές	πλαγιά	ουσιαστικό	θηλυκό, πληθυντικός, αιτιατική
στροφή	στροφή	ουσιαστικό	θηλυκό, ενικός, κλητική
κλώσα	κλώσα	ουσιαστικό	θηλυκό, ενικός, κλητική
στιγμές	στιγμή	ουσιαστικό	θηλυκό, πληθυντικός, αιτιατική
απολογισμό	απολογισμός	ουσιαστικό	αρσενικό, ενικός, αιτιατική
πελάγου	πέλαγο	ουσιαστικό	ουδέτερο, ενικός, γενική
ιδέα	ιδέα	ουσιαστικό	θηλυκό, ενικός, κλητική
διακόσμηση	διακόσμηση	ουσιαστικό	θηλυκό, ενικός, κλητική
ελαττώματα	ελάττωμα	ουσιαστικό	ουδέτερο, πληθυντικός, αιτιατική
χαλί	χαλί	ουσιαστικό	ουδέτερο, ενικός, κλητική
διακόσμηση	διακόσμηση	ουσιαστικό	θηλυκό, ενικός, κλητική
ελαττώματα	ελάττωμα	ουσιαστικό	ουδέτερο, πληθυντικός, αιτιατική
ξύλα	ξύλο	ουσιαστικό	ουδέτερο, πληθυντικός, αιτιατική
στιγμής	στιγμή	ουσιαστικό	θηλυκό, ενικός, γενική
συνάντησης	συνάντηση	ουσιαστικό	θηλυκό, ενικός, γενική
δάσους	δάσος	ουσιαστικό	ουδέτερο, ενικός, γενική
ναυαγός	ναυαγός	ουσιαστικό	αρσενικό, ενικός, ονομαστική
κλωσοπούλια	κλωσοπούλι	ουσιαστικό	ουδέτερο, πληθυντικός, αιτιατική
γέρος	γέρος	ουσιαστικό	αρσενικό, ενικός, ονομαστική
καιρό	καιρός	ουσιαστικό	αρσενικό, ενικός, αιτιατική
σκίτσα	σκίτσο	ουσιαστικό	ουδέτερο, πληθυντικός, αιτιατική
προκαταλήψεις	προκατάληψη	ουσιαστικό	θηλυκό, πληθυντικός, αιτιατική
γέρου	γέρος	ουσιαστικό	αρσενικό, ενικός, γενική
μορφής	μορφή	ουσιαστικό	θηλυκό, ενικός, γενική
κατωτερότητα	κατωτερότητα	ουσιαστικό	θηλυκό, ενικός, κλητική
διάβασμα	διάβασμα	ουσιαστικό	ουδέτερο, ενικός, κλητική
μορφές	μορφή	ουσιαστικό	θηλυκό, πληθυντικός, αιτιατική
βυθό	βυθός	ουσιαστικό	αρσενικό, ενικός, αιτιατική
κατοχή	κατοχή	ουσιαστικό	θηλυκό, ενικός, κλητική
ρόπαλα	ρόπαλο	ουσιαστικό	ουδέτερο, πληθυντικός, αιτιατική
τσούρμο	τσούρμο	ουσιαστικό	ουδέτερο, ενικός, κλητική
γήπεδο	γήπεδο	ουσιαστικό	ουδέτερο, ενικός, κλητική
παπάς	παπάς	ουσιαστικό	αρσενικό, ενικός, ονομαστική
συνείδηση	συνείδηση	ουσιαστικό	θηλυκό, ενικός, κλητική
τέκνον	τέκνο	ουσιαστικό	ουδέτερο, ενικός, ονομαστική
κουκουβάγιας	κουκουβάγια	ουσιαστικό	θηλυκό, ενικός, γενική
θαυμασμό	θαυμασμός	ουσιαστικό	αρσενικό, ενικός, αιτιατική
χαρά	χαρά	ουσιαστικό	θηλυκό, ενικός, κλητική
ζωγράφος	ζωγράφος	ουσιαστικό	θηλυκό, ενικός, ονομαστική
αφηγητής	αφηγητής	ουσιαστικό	αρσενικό, ενικός, ονομαστική
μαμάς	μαμά	ουσιαστικό	θηλυκό, ενικός, γενική
δοκίμιο	δοκίμιο	ουσιαστικό	ουδέτερο, ενικός, κλητική
χειρουργός	χειρουργός	ουσιαστικό	αρσενικό, ενικός, ονομαστική
αίμα	αίμα	ουσιαστικό	ουδέτερο, ενικός, κλητική
ξενοδοχείου	ξενοδοχείο	ουσιαστικό	ουδέτερο, ενικός, γενική
συντροφιά	συντροφιά	ουσιαστικό	θηλυκό, ενικός, κλητική
θυμό	θυμός	ουσιαστικό	αρσενικό, ενικός, αιτιατική
χρωμάτων	χρώμα	ουσιαστικό	ουδέτερο, πληθυντικός, γενική
φάλαινες	φάλαινα	ουσιαστικό	θηλυκό, πληθυντικός, αιτιατική
ρούχα	ρούχο	ουσιαστικό	ουδέτερο, πληθυντικός, αιτιατική
μεριά	μερί	ουσιαστικό	ουδέτερο, πληθυντικός, αιτιατική
αγώνα	αγώνας	ουσιαστικό	αρσενικό, ενικός, κλητική
αρχαιότητα	αρχαιότητα	ουσιαστικό	θηλυκό, ενικός, κλητική
σύννεφο	σύννεφο	ουσιαστικό	ουδέτερο, ενικός, κλητική
παλαιότητα	παλαιότητα	ουσιαστικό	θηλυκό, ενικός, κλητική
μπερντέ	μπερντές	ουσιαστικό	αρσενικό, ενικός, κλητική
καραβοκύρης	καραβοκύρης	ουσιαστικό	αρσενικό, ενικός, ονομαστική
μητέρας	μητέρα	ουσιαστικό	θηλυκό, ενικός, γενική
φιλονικίας	φιλονικία	ουσιαστικό	θηλυκό, ενικός, γενική
του	του	ουσιαστικό	άκλιτο
κάρτα	κάρτα	ουσιαστικό	θηλυκό, ενικός, κλητική
προπαππούδες	προπαππούς	ουσιαστικό	αρσενικό, πληθυντικός, αιτιατική
αγώνας	αγώνας	ουσιαστικό	αρσενικό, ενικός, ονομαστική
εθνικοτήτων	εθνικότητα	ουσιαστικό	θηλυκό, πληθυντικός, γενική
εξέλιξη	εξέλιξη	ουσιαστικό	θηλυκό, ενικός, κλητική
καραβοκύρη	καραβοκύρης	ουσιαστικό	αρσενικό, ενικός, κλητική
αναταραχή	αναταραχή	ουσιαστικό	θηλυκό, ενικός, κλητική
ρεύμα	ρεύμα	ουσιαστικό	ουδέτερο, ενικός, κλητική
φάλαινας	φάλαινα	ουσιαστικό	θηλυκό, ενικός, γενική
εξυπνάδα	εξυπνάδα	ουσιαστικό	θηλυκό, ενικός, κλητική
αυτοκίνητο	αυτοκίνητο	ουσιαστικό	ουδέτερο, ενικός, κλητική
ξαδέλφια	ξαδέλφι	ουσιαστικό	ουδέτερο, πληθυντικός, αιτιατική
βροχής	βροχή	ουσιαστικό	θηλυκό, ενικός, γενική
πιτζάμες	πιτζάμα	ουσιαστικό	θηλυκό, πληθυντικός, αιτιατική
ευφυολογημάτων	ευφυολόγημα	ουσιαστικό	ουδέτερο, πληθυντικός, γενική
ανοησίες	ανοησία	ουσιαστικό	θηλυκό, πληθυντικός, αιτιατική
προσπάθειες	προσπάθεια	ουσιαστικό	θηλυκό, πληθυντικός, αιτιατική
διάφορα	διάφορο	ουσιαστικό	ουδέτερο, πληθυντικός, αιτιατική
νερού	νερό	ουσιαστικό	ουδέτερο, ενικός, γενική
σχεδία	σχεδία	ουσιαστικό	θηλυκό, ενικός, κλητική
κορμί	κορμί	ουσιαστικό	ουδέτερο, ενικός, κλητική
μπουκιά	μπουκιά	ουσιαστικό	θηλυκό, ενικός, κλητική
αλφάβητο	αλφάβητο	ουσιαστικό	ουδέτερο, ενικός, κλητική
λουλουδιών	λουλούδι	ουσιαστικό	ουδέτερο, πληθυντικός, γενική
αιμορραγία	αιμορραγία	ουσιαστικό	θηλυκό, ενικός, κλητική
δίσκος	δίσκος	ουσιαστικό	αρσενικό, ενικός, ονομαστική
αυγό	αυγό	ουσιαστικό	ουδέτερο, ενικός, κλητική
ενδιαφέρον	ενδιαφέρον	ουσιαστικό	ουδέτερο, ενικός, κλητική
ομάδων	ομάδα	ουσιαστικό	θηλυκό, πληθυντικός, γενική
κορμό	κορμός	ουσιαστικό	αρσενικό, ενικός, αιτιατική
ανθόγαλα	ανθόγαλο	ουσιαστικό	ουδέτερο, πληθυντικός, αιτιατική
τοπίο	τοπίο	ουσιαστικό	ουδέτερο, ενικός, κλητική
αυγά	αυγό	ουσιαστικό	ουδέτερο, πληθυντικός, αιτιατική
μυρωδιά	μυρωδιά	ουσιαστικό	θηλυκό, ενικός, κλητική
γειτόνισσα	γειτόνισσα	ουσιαστικό	θηλυκό, ενικός, κλητική
δόντια	δόντι	ουσιαστικό	ουδέτερο, πληθυντικός, αιτιατική
πατέρας	πατέρας	ουσιαστικό	αρσενικό, ενικός, ονομαστική
ψωμί	ψωμί	ουσιαστικό	ουδέτερο, ενικός, κλητική
αυτοκινήτων	αυτοκίνητο	ουσιαστικό	ουδέτερο, πληθυντικός, γενική
ρίγος	ρίγος	ουσιαστικό	ουδέτερο, ενικός, κλητική
όψη	όψη	ουσιαστικό	θηλυκό, ενικός, κλητική
χειρουργού	χειρουργός	ουσιαστικό	αρσενικό, ενικός, γενική
ρόδες	ρόδα	ουσιαστικό	θηλυκό, πληθυντικός, αιτιατική
δρεπάνι	δρεπάνι	ουσιαστικό	ουδέτερο, ενικός, κλητική
γραμμή	γραμμή	ουσιαστικό	θηλυκό, ενικός, κλητική
φλούδες	φλούδα	ουσιαστικό	θηλυκό, πληθυντικός, αιτιατική
αρμάτων	άρμα	ουσιαστικό	ουδέτερο, πληθυντικός, γενική
ανωμαλία	ανωμαλία	ουσιαστικό	θηλυκό, ενικός, κλητική
ποδόσφαιρο	ποδόσφαιρο	ουσιαστικό	ουδέτερο, ενικός, κλητική
τσίρκο	τσίρκο	ουσιαστικό	ουδέτερο, ενικός, κλητική
πολιτείας	πολιτεία	ουσιαστικό	θηλυκό, ενικός, γενική
καναπέ	καναπές	ουσιαστικό	αρσενικό, ενικός, κλητική
κομπιούτερ	κομπιούτερ	ουσιαστικό	άκλιτο
αναπαράσταση	αναπαράσταση	ουσιαστικό	θηλυκό, ενικός, κλητική
παράδειγμα	παράδειγμα	ουσιαστικό	ουδέτερο, ενικός, κλητική
βιβλίο	βιβλίο	ουσιαστικό	ουδέτερο, ενικός, κλητική
μομφές	μομφή	ουσιαστικό	θηλυκό, πληθυντικός, αιτιατική
βιβλία	βιβλίο	ουσιαστικό	ουδέτερο, πληθυντικός, αιτιατική
δίκιο	δίκιο	ουσιαστικό	ουδέτερο, ενικός, κλητική
πλάτανο	πλάτανος	ουσιαστικό	αρσενικό, ενικός, αιτιατική
δέρμα	δέρμα	ουσιαστικό	ουδέτερο, ενικός, κλητική
ταυρομάχο	ταυρομάχος	ουσιαστικό	αρσενικό, ενικός, αιτιατική
ιστορία	ιστορία	ουσιαστικό	θηλυκό, ενικός, κλητική
ταυρομάχε	ταυρομάχος	ουσιαστικό	αρσενικό, ενικός, κλητική
πέρδικας	πέρδικα	ουσιαστικό	θηλυκό, ενικός, γενική
σημεία	σημείο	ουσιαστικό	ουδέτερο, πληθυντικός, αιτιατική
λόξιγκα	λόξιγκας	ουσιαστικό	αρσενικό, ενικός, κλητική
λόξιγκα	λόξιγκας	ουσιαστικό	αρσενικό, ενικός, κλητική
σημείο	σημείο	ουσιαστικό	ουδέτερο, ενικός, κλητική
θύελλες	θύελλα	ουσιαστικό	θηλυκό, πληθυντικός, αιτιατική
κατόρθωμα	κατόρθωμα	ουσιαστικό	ουδέτερο, ενικός, κλητική
διάσημου	διάσημο	ουσιαστικό	ουδέτερο, ενικός, γενική
συναίσθημα	συναίσθημα	ουσιαστικό	ουδέτερο, ενικός, κλητική
ζέστη	ζέστη	ουσιαστικό	θηλυκό, ενικός, κλητική
κλωνάρι	κλωνάρι	ουσιαστικό	ουδέτερο, ενικός, κλητική
χήρα	χήρα	ουσιαστικό	θηλυκό, ενικός, κλητική
αυτί	αυτί	ουσιαστικό	ουδέτερο, ενικός, κλητική
μορφή	μορφή	ουσιαστικό	θηλυκό, ενικός, κλητική
ορατότητα	ορατότητα	ουσιαστικό	θηλυκό, ενικός, κλητική
διάστημα	διάστημα	ουσιαστικό	ουδέτερο, ενικός, κλητική
σφυρίχτρα	σφυρίχτρα	ουσιαστικό	θηλυκό, ενικός, κλητική
χειροκροτημάτων	χειροκρότημα	ουσιαστικό	ουδέτερο, πληθυντικός, γενική
αντί	αντί	ουσιαστικό	ουδέτερο, ενικός, κλητική
συγγραφέας	συγγραφέας	ουσιαστικό	αρσενικό, ενικός, ονομαστική
δεκάρικο	δεκάρικο	ουσιαστικό	ουδέτερο, ενικός, κλητική
αεροστάτων	αερόστατο	ουσιαστικό	ουδέτερο, πληθυντικός, γενική
ραψωδία	ραψωδία	ουσιαστικό	θηλυκό, ενικός, κλητική
φύση	φύση	ουσιαστικό	θηλυκό, ενικός, κλητική
μα	μα	ουσιαστικό	άκλιτο
άνθρωπο	άνθρωπος	ουσιαστικό	αρσενικό, ενικός, αιτιατική
ιδρώτας	ιδρώτας	ουσιαστικό	αρσενικό, ενικός, ονομαστική
άνθρωποι	άνθρωπος	ουσιαστικό	αρσενικό, πληθυντικός, κλητική
θριάμβου	θρίαμβος	ουσιαστικό	αρσενικό, ενικός, γενική
τζάκι	τζάκι	ουσιαστικό	ουδέτερο, ενικός, κλητική
ανικανότητα	ανικανότητα	ουσιαστικό	θηλυκό, ενικός, κλητική
θέμα	θέμα	ουσιαστικό	ουδέτερο, ενικός, κλητική
άνθρωπος	άνθρωπος	ουσιαστικό	αρσενικό, ενικός, ονομαστική
ορτανσίες	ορτανσία	ουσιαστικό	θηλυκό, πληθυντικός, αιτιατική
ρόλους	ρόλος	ουσιαστικό	αρσενικό, πληθυντικός, αιτιατική
γραμμές	γραμμή	ουσιαστικό	θηλυκό, πληθυντικός, αιτιατική
σκιές	σκιά	ουσιαστικό	θηλυκό, πληθυντικός, αιτιατική
ώρα	ώρα	ουσιαστικό	θηλυκό, ενικός, κλητική
γραμμής	γραμμή	ουσιαστικό	θηλυκό, ενικός, γενική
στάχυα	στάχυ	ουσιαστικό	ουδέτερο, πληθυντικός, αιτιατική
όρεξη	όρεξη	ουσιαστικό	θηλυκό, ενικός, κλητική
γιατροί	γιατρός	ουσιαστικό	αρσενικό, πληθυντικός, κλητική
ζω	ζω	ουσιαστικό	άκλιτο
κυρά	κυρά	ουσιαστικό	θηλυκό, ενικός, κλητική
ταύρους	ταύρος	ουσιαστικό	αρσενικό, πληθυντικός, αιτιατική
ψυχής	ψυχή	ουσιαστικό	θηλυκό, ενικός, γενική
νερό	νερό	ουσιαστικό	ουδέτερο, ενικός, κλητική
φύλλου	φύλλο	ουσιαστικό	ουδέτερο, ενικός, γενική
συνθηκών	συνθήκη	ουσιαστικό	θηλυκό, πληθυντικός, γενική
πρόσωπα	πρόσωπο	ουσιαστικό	ουδέτερο, πληθυντικός, αιτιατική
σκέψεις	σκέψη	ουσιαστικό	θηλυκό, πληθυντικός, αιτιατική
μπάλας	μπάλα	ουσιαστικό	θηλυκό, ενικός, γενική
πρόσωπο	πρόσωπο	ουσιαστικό	ουδέτερο, ενικός, κλητική
νησιού	νησί	ουσιαστικό	ουδέτερο, ενικός, γενική
πρόσωπο	πρόσωπο	ουσιαστικό	ουδέτερο, ενικός, κλητική
σχάρα	σχάρα	ουσιαστικό	θηλυκό, ενικός, κλητική
αυλή	αυλή	ουσιαστικό	θηλυκό, ενικός, κλητική
θλίψη	θλίψη	ουσιαστικό	θηλυκό, ενικός, κλητική
ερωτήσεις	ερώτηση	ουσιαστικό	θηλυκό, πληθυντικός, αιτιατική
πόδι	πόδι	ουσιαστικό	ουδέτερο, ενικός, κλητική
εθνικότητα	εθνικότητα	ουσιαστικό	θηλυκό, ενικός, κλητική
γη	γη	ουσιαστικό	θηλυκό, ενικός, κλητική
εντύπωση	εντύπωση	ουσιαστικό	θηλυκό, ενικός, κλητική
καθαρίστρια	καθαρίστρια	ουσιαστικό	θηλυκό, ενικός, κλητική
καλντερίμια	καλντερίμι	ουσιαστικό	ουδέτερο, πληθυντικός, αιτιατική
τραπέζι	τραπέζι	ουσιαστικό	ουδέτερο, ενικός, κλητική
γιατρέ	γιατρός	ουσιαστικό	αρσενικό, ενικός, κλητική
θέση	θέση	ουσιαστικό	θηλυκό, ενικός, κλητική
πολιτισμό	πολιτισμός	ουσιαστικό	αρσενικό, ενικός, αιτιατική
αποφάσεις	απόφαση	ουσιαστικό	θηλυκό, πληθυντικός, αιτιατική
ξεγύμνωμα	ξεγύμνωμα	ουσιαστικό	ουδέτερο, ενικός, κλητική
γωνιά	γωνιά	ουσιαστικό	θηλυκό, ενικός, κλητική
γνώστης	γνώστης	ουσιαστικό	αρσενικό, ενικός, ονομαστική
χρυσοθήρες	χρυσοθήρας	ουσιαστικό	αρσενικό, πληθυντικός, αιτιατική
κοπέλα	κοπέλα	ουσιαστικό	θηλυκό, ενικός, κλητική
απορία	απορία	ουσιαστικό	θηλυκό, ενικός, κλητική
σιωπή	σιωπή	ουσιαστικό	θηλυκό, ενικός, κλητική
ήττα	ήττα	ουσιαστικό	θηλυκό, ενικός, κλητική
χώρος	χώρος	ουσιαστικό	αρσενικό, ενικός, ονομαστική
λεωφόρο	λεωφόρος	ουσιαστικό	θηλυκό, ενικός, κλητική
συνέχεια	συνέχεια	ουσιαστικό	θηλυκό, ενικός, κλητική
γιαλού	γιαλός	ουσιαστικό	αρσενικό, ενικός, γενική
ανθρώπου	άνθρωπος	ουσιαστικό	αρσενικό, ενικός, γενική
κατάλοιπο	κατάλοιπο	ουσιαστικό	ουδέτερο, ενικός, κλητική
δασκάλου	δάσκαλος	ουσιαστικό	αρσενικό, ενικός, γενική
οικοτροφεία	οικοτροφείο	ουσιαστικό	ουδέτερο, πληθυντικός, αιτιατική
στήθος	στήθος	ουσιαστικό	ουδέτερο, ενικός, κλητική
μυαλό	μυαλό	ουσιαστικό	ουδέτερο, ενικός, κλητική
αμαξών	άμαξα	ουσιαστικό	θηλυκό, πληθυντικός, γενική
αστροφεγγιά	αστροφεγγιά	ουσιαστικό	θηλυκό, ενικός, κλητική
μπακ	μπακ	ουσιαστικό	άκλιτο
παράσταση	παράσταση	ουσιαστικό	θηλυκό, ενικός, κλητική
ουρανό	ουρανός	ουσιαστικό	αρσενικό, ενικός, αιτιατική
μπαλκόνια	μπαλκόνι	ουσιαστικό	ουδέτερο, πληθυντικός, αιτιατική
κομψότητα	κομψότητα	ουσιαστικό	θηλυκό, ενικός, κλητική
σκάφος	σκάφος	ουσιαστικό	ουδέτερο, ενικός, κλητική
κραυγή	κραυγή	ουσιαστικό	θηλυκό, ενικός, κλητική
φρύδια	φρύδι	ουσιαστικό	ουδέτερο, πληθυντικός, αιτιατική
εβραίας	εβραία	ουσιαστικό	θηλυκό, ενικός, γενική
εξέδρας	εξέδρα	ουσιαστικό	θηλυκό, ενικός, γενική
πέλαγο	πέλαγο	ουσιαστικό	ουδέτερο, ενικός, κλητική
λάκτισμα	λάκτισμα	ουσιαστικό	ουδέτερο, ενικός, κλητική
οισοφάγος	οισοφάγος	ουσιαστικό	αρσενικό, ενικός, ονομαστική
οισοφάγου	οισοφάγος	ουσιαστικό	αρσενικό, ενικός, γενική
πολυθρόνα	πολυθρόνα	ουσιαστικό	θηλυκό, ενικός, κλητική
ψωμάδες	ψωμάς	ουσιαστικό	αρσενικό, πληθυντικός, αιτιατική
ρόλο	ρόλος	ουσιαστικό	αρσενικό, ενικός, αιτιατική
ζαρκάδια	ζαρκάδι	ουσιαστικό	ουδέτερο, πληθυντικός, αιτιατική
ντέρμπι	ντέρμπι	ουσιαστικό	άκλιτο
ανθρώπων	άνθρωπος	ουσιαστικό	αρσενικό, πληθυντικός, γενική
θεός	θεός	ουσιαστικό	αρσενικό, ενικός, ονομαστική
καλοκαιριού	καλοκαίρι	ουσιαστικό	ουδέτερο, ενικός, γενική
πείσμα	πείσμα	ουσιαστικό	ουδέτερο, ενικός, κλητική
δέρματα	δέρμα	ουσιαστικό	ουδέτερο, πληθυντικός, αιτιατική
επίσκεψη	επίσκεψη	ουσιαστικό	θηλυκό, ενικός, κλητική
δυνάστη	δυνάστης	ουσιαστικό	αρσενικό, ενικός, κλητική
πεταλούδα	πεταλούδα	ουσιαστικό	θηλυκό, ενικός, κλητική
φυλής	φυλή	ουσιαστικό	θηλυκό, ενικός, γενική
κίνηση	κίνηση	ουσιαστικό	θηλυκό, ενικός, κλητική
κάματο	κάματος	ουσιαστικό	αρσενικό, ενικός, αιτιατική
ποντίκι	ποντίκι	ουσιαστικό	ουδέτερο, ενικός, κλητική
ηλικιών	ηλικία	ουσιαστικό	θηλυκό, πληθυντικός, γενική
χρυσοθήρα	χρυσοθήρας	ουσιαστικό	αρσενικό, ενικός, κλητική
θρόνο	θρόνοι	ουσιαστικό	αρσενικό, ενικός, αιτιατική
μάτια	μάτι	ουσιαστικό	ουδέτερο, πληθυντικός, αιτιατική
αυτόματα	αυτόματο	ουσιαστικό	ουδέτερο, πληθυντικός, αιτιατική
παραλλαγή	παραλλαγή	ουσιαστικό	θηλυκό, ενικός, κλητική
χρέη	χρέος	ουσιαστικό	ουδέτερο, πληθυντικός, αιτιατική
αναστατώσεων	αναστάτωση	ουσιαστικό	θηλυκό, πληθυντικός, γενική
οδηγίες	οδηγία	ουσιαστικό	θηλυκό, πληθυντικός, αιτιατική
μάρτυρα	μάρτυρας	ουσιαστικό	αρσενικό, ενικός, κλητική
επιδρομών	επιδρομή	ουσιαστικό	θηλυκό, πληθυντικός, γενική
ακτής	ακτή	ουσιαστικό	θηλυκό, ενικός, γενική
γιατρός	γιατρός	ουσιαστικό	αρσενικό, ενικός, ονομαστική
χαν	χαν	ουσιαστικό	άκλιτο
σχήματα	σχήμα	ουσιαστικό	ουδέτερο, πληθυντικός, αιτιατική
παλατιού	παλάτι	ουσιαστικό	ουδέτερο, ενικός, γενική
ράσα	ράσο	ουσιαστικό	ουδέτερο, πληθυντικός, αιτιατική
μονόξυλα	μονόξυλο	ουσιαστικό	ουδέτερο, πληθυντικός, αιτιατική
χαρτόνι	χαρτόνι	ουσιαστικό	ουδέτερο, ενικός, κλητική
γάλα	γάλα	ουσιαστικό	ουδέτερο, ενικός, κλητική
βερμούδες	βερμούδα	ουσιαστικό	θηλυκό, πληθυντικός, αιτιατική
αγελάδας	αγελάδα	ουσιαστικό	θηλυκό, ενικός, γενική
παιχτών	παίχτης	ουσιαστικό	αρσενικό, πληθυντικός, γενική
ανάκρισης	ανάκριση	ουσιαστικό	θηλυκό, ενικός, γενική
ημέρας	ημέρα	ουσιαστικό	θηλυκό, ενικός, γενική
πόθων	πόθος	ουσιαστικό	αρσενικό, πληθυντικός, γενική
άτομα	άτομο	ουσιαστικό	ουδέτερο, πληθυντικός, αιτιατική
τσέπες	τσέπη	ουσιαστικό	θηλυκό, πληθυντικός, αιτιατική
συγγραφέα	συγγραφέας	ουσιαστικό	αρσενικό, ενικός, κλητική
τόπο	τόπος	ουσιαστικό	αρσενικό, ενικός, αιτιατική
φασαρία	φασαρίας	ουσιαστικό	αρσενικό, ενικός, κλητική
κακάρισμα	κακάρισμα	ουσιαστικό	ουδέτερο, ενικός, κλητική
ώρας	ώρα	ουσιαστικό	θηλυκό, ενικός, γενική
αλεύρι	αλεύρι	ουσιαστικό	ουδέτερο, ενικός, κλητική
χτυπήματα	χτύπημα	ουσιαστικό	ουδέτερο, πληθυντικός, αιτιατική
καταγωγή	καταγωγή	ουσιαστικό	θηλυκό, ενικός, κλητική
έλξη	έλξη	ουσιαστικό	θηλυκό, ενικός, κλητική
ήρωες	ήρωας	ουσιαστικό	αρσενικό, πληθυντικός, αιτιατική
δύναμη	δύναμη	ουσιαστικό	θηλυκό, ενικός, κλητική
ελλήνων	έλληνας	ουσιαστικό	αρσενικό, πληθυντικός, γενική
κέντρο	κέντρο	ουσιαστικό	ουδέτερο, ενικός, κλητική
κίνδυνο	κίνδυνος	ουσιαστικό	αρσενικό, ενικός, αιτιατική
δύναμη	δύναμη	ουσιαστικό	θηλυκό, ενικός, κλητική
ανατολή	ανατολή	ουσιαστικό	θηλυκό, ενικός, κλητική
οικοδέσποινας	οικοδέσποινα	ουσιαστικό	θηλυκό, ενικός, γενική
γάτα	γάτα	ουσιαστικό	θηλυκό, ενικός, κλητική
σύμφωνα	σύμφωνο	ουσιαστικό	ουδέτερο, πληθυντικός, αιτιατική
επαφή	επαφή	ουσιαστικό	θηλυκό, ενικός, κλητική
κουταλιά	κουταλιά	ουσιαστικό	θηλυκό, ενικός, κλητική
δασκάλα	δασκάλα	ουσιαστικό	θηλυκό, ενικός, κλητική
τειχών	τείχος	ουσιαστικό	ουδέτερο, πληθυντικός, γενική
πάτερ	πάτερ	ουσιαστικό	άκλιτο
χιόνι	χιόνι	ουσιαστικό	ουδέτερο, ενικός, κλητική
διαθέσεων	διάθεση	ουσιαστικό	θηλυκό, πληθυντικός, γενική
πλευράς	πλευρά	ουσιαστικό	θηλυκό, ενικός, γενική
διήγημα	διήγημα	ουσιαστικό	ουδέτερο, ενικός, κλητική
ήρωας	ήρωας	ουσιαστικό	αρσενικό, ενικός, ονομαστική
πίπιζα	πίπιζα	ουσιαστικό	θηλυκό, ενικός, κλητική
τόνο	τόνος	ουσιαστικό	αρσενικό, ενικός, αιτιατική
άνεση	άνεση	ουσιαστικό	θηλυκό, ενικός, κλητική
φώτα	φως	ουσιαστικό	ουδέτερο, πληθυντικός, αιτιατική
φως	φως	ουσιαστικό	ουδέτερο, ενικός, κλητική
κριάρι	κριάρι	ουσιαστικό	ουδέτερο, ενικός, κλητική
διαταγή	διαταγή	ουσιαστικό	θηλυκό, ενικός, κλητική
ρεζίλι	ρεζίλι	ουσιαστικό	, ενικός, κλητική
ψυχολογία	ψυχολογία	ουσιαστικό	θηλυκό, ενικός, κλητική
θάλασσα	θάλασσα	ουσιαστικό	θηλυκό, ενικός, κλητική
παράστασης	παράσταση	ουσιαστικό	θηλυκό, ενικός, γενική
ματς	ματς	ουσιαστικό	άκλιτο
μπρετέλες	μπρετέλα	ουσιαστικό	θηλυκό, πληθυντικός, αιτιατική
κλοτσιές	κλοτσιά	ουσιαστικό	θηλυκό, πληθυντικός, αιτιατική
εκκλησίας	εκκλησία	ουσιαστικό	θηλυκό, ενικός, γενική
αρχαιότητας	αρχαιότητα	ουσιαστικό	θηλυκό, ενικός, γενική
τάσεις	τάση	ουσιαστικό	θηλυκό, πληθυντικός, αιτιατική
παράθυρο	παράθυρο	ουσιαστικό	ουδέτερο, ενικός, κλητική
φιγούρες	φιγούρα	ουσιαστικό	θηλυκό, πληθυντικός, αιτιατική
κλίσεις	κλίση	ουσιαστικό	θηλυκό, πληθυντικός, αιτιατική
ράμφος	ράμφος	ουσιαστικό	ουδέτερο, ενικός, κλητική
τουρκοπούλα	τουρκοπούλα	ουσιαστικό	θηλυκό, ενικός, κλητική
οισοφάγο	οισοφάγος	ουσιαστικό	αρσενικό, ενικός, αιτιατική
απόσπασμα	απόσπασμα	ουσιαστικό	ουδέτερο, ενικός, κλητική
σκιών	σκιά	ουσιαστικό	θηλυκό, πληθυντικός, γενική
γρουσουζιά	γρουσουζιά	ουσιαστικό	θηλυκό, ενικός, κλητική
σπιτάκι	σπίτι	 ουσιαστικό	 ουδέτερο, ενικός, ονομαστική, αιτιατική, κλητική, ονομαστική, αιτιατική, κλητική
μέρος	μέρος	ουσιαστικό	ουδέτερο, ενικός, κλητική
χαρτί	χαρτί	ουσιαστικό	ουδέτερο, ενικός, κλητική
νου	νου	ουσιαστικό	άκλιτο
θεοί	θεός	ουσιαστικό	αρσενικό, πληθυντικός, κλητική
ποδιών	πόδι	ουσιαστικό	ουδέτερο, πληθυντικός, γενική
πλάσμα	πλάσμα	ουσιαστικό	ουδέτερο, ενικός, κλητική
όνειρο	όνειρο	ουσιαστικό	ουδέτερο, ενικός, κλητική
τοιχώματα	τοίχωμα	ουσιαστικό	ουδέτερο, πληθυντικός, αιτιατική
πουλί	πουλί	ουσιαστικό	ουδέτερο, ενικός, κλητική
στίχοι	στίχος	ουσιαστικό	αρσενικό, πληθυντικός, κλητική
αλάνα	αλάνα	ουσιαστικό	θηλυκό, ενικός, κλητική
γλώσσα	γλώσσα	ουσιαστικό	θηλυκό, ενικός, κλητική
αντικείμενα	αντικείμενο	ουσιαστικό	ουδέτερο, πληθυντικός, αιτιατική
παραδόσεων	παράδοση	ουσιαστικό	θηλυκό, πληθυντικός, γενική
λαγκαδιά	λαγκαδιά	ουσιαστικό	θηλυκό, ενικός, κλητική
λύκος	λύκος	ουσιαστικό	αρσενικό, ενικός, ονομαστική
μήκος	μήκος	ουσιαστικό	ουδέτερο, ενικός, κλητική
λαρυγγιού	λαρύγγι	ουσιαστικό	ουδέτερο, ενικός, γενική
δείγματα	δείγμα	ουσιαστικό	ουδέτερο, πληθυντικός, αιτιατική
μέρες	μέρα	ουσιαστικό	θηλυκό, πληθυντικός, αιτιατική
παίχτες	παίχτης	ουσιαστικό	αρσενικό, πληθυντικός, αιτιατική
υπόθεση	υπόθεση	ουσιαστικό	θηλυκό, ενικός, κλητική
κόμπους	κόμπος	ουσιαστικό	αρσενικό, πληθυντικός, αιτιατική
παιδί	παιδί	ουσιαστικό	ουδέτερο, ενικός, κλητική
θάνατο	θάνατος	ουσιαστικό	αρσενικό, ενικός, αιτιατική
λιβάδια	λιβάδι	ουσιαστικό	ουδέτερο, πληθυντικός, αιτιατική
πόλη	πόλη	ουσιαστικό	θηλυκό, ενικός, κλητική
παίχτης	παίχτης	ουσιαστικό	αρσενικό, ενικός, ονομαστική
συνοικίας	συνοικία	ουσιαστικό	θηλυκό, ενικός, γενική
πράγματα	πράγμα	ουσιαστικό	ουδέτερο, πληθυντικός, αιτιατική
έδαφος	έδαφος	ουσιαστικό	ουδέτερο, ενικός, κλητική
κόκα	κόκα	ουσιαστικό	θηλυκό, ενικός, κλητική
στίβο	στίβος	ουσιαστικό	αρσενικό, ενικός, αιτιατική
κέφαλο	κέφαλος	ουσιαστικό	αρσενικό, ενικός, αιτιατική
παραμυθιών	παραμύθι	ουσιαστικό	ουδέτερο, πληθυντικός, γενική
εβδομηνταριά	εβδομηνταριά	ουσιαστικό	θηλυκό, ενικός, κλητική
σημαίας	σημαία	ουσιαστικό	θηλυκό, ενικός, γενική
μίσος	μίσος	ουσιαστικό	ουδέτερο, ενικός, κλητική
αέρας	αέρας	ουσιαστικό	αρσενικό, ενικός, ονομαστική
κορδέλα	κορδέλα	ουσιαστικό	θηλυκό, ενικός, κλητική
γέροντας	γέροντας	ουσιαστικό	αρσενικό, ενικός, ονομαστική
κυρίας	κυρία	ουσιαστικό	θηλυκό, ενικός, γενική
θεό	θεός	ουσιαστικό	αρσενικό, ενικός, αιτιατική
πατρίδας	πατρίδα	ουσιαστικό	θηλυκό, ενικός, γενική
καρδιά	καρδιά	ουσιαστικό	θηλυκό, ενικός, κλητική
μανίκι	μανίκι	ουσιαστικό	ουδέτερο, ενικός, κλητική
ανάγκη	ανάγκη	ουσιαστικό	θηλυκό, ενικός, κλητική
ρέμα	ρέμα	ουσιαστικό	ουδέτερο, ενικός, κλητική
συνωστισμός	συνωστισμός	ουσιαστικό	αρσενικό, ενικός, ονομαστική
τέρμα	τέρμα	ουσιαστικό	ουδέτερο, ενικός, κλητική
βασιλιάς	βασιλιάς	ουσιαστικό	αρσενικό, ενικός, ονομαστική
αλήθεια	αλήθεια	ουσιαστικό	θηλυκό, ενικός, κλητική
βέλο	βέλο	ουσιαστικό	ουδέτερο, ενικός, κλητική
επισημότητα	επισημότητα	ουσιαστικό	θηλυκό, ενικός, κλητική
αυλοκόλακες	αυλοκόλακας	ουσιαστικό	αρσενικό, πληθυντικός, αιτιατική
αισθήματος	αίσθημα	ουσιαστικό	ουδέτερο, ενικός, γενική
κολύμπι	κολύμπι	ουσιαστικό	, ενικός, κλητική
δεμάτια	δεμάτι	ουσιαστικό	ουδέτερο, πληθυντικός, αιτιατική
στοχασμών	στοχασμός	ουσιαστικό	αρσενικό, πληθυντικός, γενική
νερόμυλος	νερόμυλος	ουσιαστικό	αρσενικό, ενικός, ονομαστική
γιάρδες	γιάρδα	ουσιαστικό	θηλυκό, πληθυντικός, αιτιατική
γέρο	γέρος	ουσιαστικό	αρσενικό, ενικός, κλητική
βλαστός	βλαστός	ουσιαστικό	αρσενικό, ενικός, ονομαστική
βωμολοχιών	βωμολοχία	ουσιαστικό	θηλυκό, πληθυντικός, γενική
βασιλιάδες	βασιλιάς	ουσιαστικό	αρσενικό, πληθυντικός, αιτιατική
εποχής	εποχή	ουσιαστικό	θηλυκό, ενικός, γενική
σταθμούς	σταθμός	ουσιαστικό	αρσενικό, πληθυντικός, αιτιατική
αιώνες	αιώνας	ουσιαστικό	αρσενικό, πληθυντικός, αιτιατική
δίνη	δίνη	ουσιαστικό	θηλυκό, ενικός, κλητική
ανθοφορία	ανθοφορία	ουσιαστικό	θηλυκό, ενικός, κλητική
εβραίων	εβραίος	ουσιαστικό	αρσενικό, πληθυντικός, γενική
εικόνες	εικόνα	ουσιαστικό	θηλυκό, πληθυντικός, αιτιατική
δύση	δύση	ουσιαστικό	θηλυκό, ενικός, κλητική
παρανόηση	παρανόηση	ουσιαστικό	θηλυκό, ενικός, κλητική
ποδιού	πόδι	ουσιαστικό	ουδέτερο, ενικός, γενική
ψάρια	ψάρι	ουσιαστικό	ουδέτερο, πληθυντικός, αιτιατική
ριπές	ριπή	ουσιαστικό	θηλυκό, πληθυντικός, αιτιατική
εντυπώσεις	εντύπωση	ουσιαστικό	θηλυκό, πληθυντικός, αιτιατική
λίμνη	λίμνη	ουσιαστικό	θηλυκό, ενικός, κλητική
περίπτωση	περίπτωση	ουσιαστικό	θηλυκό, ενικός, κλητική
φύλλα	φύλλο	ουσιαστικό	ουδέτερο, πληθυντικός, αιτιατική
άκρη	άκρη	ουσιαστικό	θηλυκό, ενικός, κλητική
πάντα	πάντα	ουσιαστικό	άκλιτο
φιλοσόφου	φιλόσοφος	ουσιαστικό	αρσενικό, ενικός, γενική
φύλλο	φύλλο	ουσιαστικό	ουδέτερο, ενικός, κλητική
σταυρού	σταυρός	ουσιαστικό	αρσενικό, ενικός, γενική
ψωμιά	ψωμί	ουσιαστικό	ουδέτερο, πληθυντικός, αιτιατική
μαρτύρια	μαρτύριο	ουσιαστικό	ουδέτερο, πληθυντικός, αιτιατική
αιώνας	αιώνας	ουσιαστικό	αρσενικό, ενικός, ονομαστική
προσέγγιση	προσέγγιση	ουσιαστικό	θηλυκό, ενικός, κλητική
ηρεμία	ηρεμία	ουσιαστικό	θηλυκό, ενικός, κλητική
ίχνη	ίχνος	ουσιαστικό	ουδέτερο, πληθυντικός, αιτιατική
μαμά	μαμά	ουσιαστικό	θηλυκό, ενικός, κλητική
θέσης	θέση	ουσιαστικό	θηλυκό, ενικός, γενική
σούρουπο	σούρουπο	ουσιαστικό	ουδέτερο, ενικός, κλητική
φορεσιάς	φορεσιά	ουσιαστικό	θηλυκό, ενικός, γενική
πάσα	πάσο	ουσιαστικό	ουδέτερο, πληθυντικός, αιτιατική
ομπρέλες	ομπρέλα	ουσιαστικό	θηλυκό, πληθυντικός, αιτιατική
όχθη	όχθη	ουσιαστικό	θηλυκό, ενικός, κλητική
αξία	αξία	ουσιαστικό	θηλυκό, ενικός, κλητική
βουνού	βουνό	ουσιαστικό	ουδέτερο, ενικός, γενική
εξώστες	εξώστης	ουσιαστικό	αρσενικό, πληθυντικός, αιτιατική
διάκος	διάκος	ουσιαστικό	αρσενικό, ενικός, ονομαστική
οδύσσεια	οδύσσεια	ουσιαστικό	θηλυκό, ενικός, κλητική
πάσες	πάσα	ουσιαστικό	θηλυκό, πληθυντικός, αιτιατική
αγγέλων	άγγελος	ουσιαστικό	αρσενικό, πληθυντικός, γενική
τρόμος	τρόμος	ουσιαστικό	αρσενικό, ενικός, ονομαστική
γλώσσας	γλώσσα	ουσιαστικό	θηλυκό, ενικός, γενική
διάταξη	διάταξη	ουσιαστικό	θηλυκό, ενικός, κλητική
φώτιση	φώτιση	ουσιαστικό	θηλυκό, ενικός, κλητική
φράξος	φράξος	ουσιαστικό	αρσενικό, ενικός, ονομαστική
κότα	κότα	ουσιαστικό	θηλυκό, ενικός, κλητική
μουσούδα	μουσούδα	ουσιαστικό	θηλυκό, ενικός, κλητική
κυνηγόσκυλο	κυνηγόσκυλο	ουσιαστικό	ουδέτερο, ενικός, κλητική
νίκη	νίκη	ουσιαστικό	θηλυκό, ενικός, κλητική
σκαθάρι	σκαθάρι	ουσιαστικό	ουδέτερο, ενικός, κλητική
πλευρών	πλευρό	ουσιαστικό	ουδέτερο, πληθυντικός, γενική
διαιτητή	διαιτητής	ουσιαστικό	αρσενικό, ενικός, κλητική
διάσταση	διάσταση	ουσιαστικό	θηλυκό, ενικός, κλητική
παναγιά	παναγιά	ουσιαστικό	θηλυκό, ενικός, κλητική
άσε	άσος	ουσιαστικό	αρσενικό, ενικός, κλητική
άρη	άρης	ουσιαστικό	αρσενικό, ενικός, κλητική
συλλογή	συλλογή	ουσιαστικό	θηλυκό, ενικός, κλητική
φτέρες	φτέρη	ουσιαστικό	θηλυκό, πληθυντικός, αιτιατική
εχθρού	εχθρός	ουσιαστικό	αρσενικό, ενικός, γενική
χάρη	χάρη	ουσιαστικό	θηλυκό, ενικός, κλητική
ρυάκι	ρυάκι	ουσιαστικό	ουδέτερο, ενικός, κλητική
αεροπλάνων	αεροπλάνο	ουσιαστικό	ουδέτερο, πληθυντικός, γενική
ποινών	ποινή	ουσιαστικό	θηλυκό, πληθυντικός, γενική
διάρκεια	διάρκεια	ουσιαστικό	θηλυκό, ενικός, κλητική
κλαδί	κλαδί	ουσιαστικό	ουδέτερο, ενικός, κλητική
πάτωμα	πάτωμα	ουσιαστικό	ουδέτερο, ενικός, κλητική
ύφαλα	ύφαλα	ουσιαστικό	ουδέτερο, πληθυντικός, αιτιατική
γνώση	γνώση	ουσιαστικό	θηλυκό, ενικός, κλητική
βεγγαλικά	βεγγαλικό	ουσιαστικό	ουδέτερο, πληθυντικός, αιτιατική
αρχοντιάς	αρχοντιά	ουσιαστικό	θηλυκό, ενικός, γενική
κόλα	κόλο	ουσιαστικό	ουδέτερο, πληθυντικός, αιτιατική
κτιρίων	κτίριο	ουσιαστικό	ουδέτερο, πληθυντικός, γενική
δρόμο	δρόμος	ουσιαστικό	αρσενικό, ενικός, αιτιατική
ροΐ	ροΐ	ουσιαστικό	ουδέτερο, ενικός, κλητική
μικρογραφιών	μικρογραφία	ουσιαστικό	θηλυκό, πληθυντικός, γενική
καλοκαίρι	καλοκαίρι	ουσιαστικό	ουδέτερο, ενικός, κλητική
παιχνίδι	παιχνίδι	ουσιαστικό	ουδέτερο, ενικός, κλητική
χτένας	χτένα	ουσιαστικό	θηλυκό, ενικός, γενική
βιβλίο	βιβλίο	ουσιαστικό	ουδέτερο, ενικός, κλητική
λίτρες	λίτρα	ουσιαστικό	θηλυκό, πληθυντικός, αιτιατική
είσοδο	είσοδος	ουσιαστικό	θηλυκό, ενικός, κλητική
παγίδες	παγίδα	ουσιαστικό	θηλυκό, πληθυντικός, αιτιατική
διδασκαλία	διδασκαλία	ουσιαστικό	θηλυκό, ενικός, κλητική
νησί	νησί	ουσιαστικό	ουδέτερο, ενικός, κλητική
αυτονομία	αυτονομία	ουσιαστικό	θηλυκό, ενικός, κλητική
συμπρωταγωνιστές	συμπρωταγωνιστής	ουσιαστικό	αρσενικό, πληθυντικός, αιτιατική
δαιμόνων	δαίμονας	ουσιαστικό	αρσενικό, πληθυντικός, γενική
πλάτος	πλάτος	ουσιαστικό	ουδέτερο, ενικός, κλητική
μπαμπάς	μπαμπάς	ουσιαστικό	αρσενικό, ενικός, ονομαστική
κλειδί	κλειδί	ουσιαστικό	ουδέτερο, ενικός, κλητική
ιδιότητα	ιδιότητα	ουσιαστικό	θηλυκό, ενικός, κλητική
λέξη	λέξη	ουσιαστικό	θηλυκό, ενικός, κλητική
σχέδια	σχέδιο	ουσιαστικό	ουδέτερο, πληθυντικός, αιτιατική
επαίνους	έπαινος	ουσιαστικό	αρσενικό, πληθυντικός, αιτιατική
βουνά	βουνό	ουσιαστικό	ουδέτερο, πληθυντικός, αιτιατική
σχέδια	σχέδιο	ουσιαστικό	ουδέτερο, πληθυντικός, αιτιατική
γιατρικά	γιατρικό	ουσιαστικό	ουδέτερο, πληθυντικός, αιτιατική
σχέδιο	σχέδιο	ουσιαστικό	ουδέτερο, ενικός, κλητική
ουρλιαχτό	ουρλιαχτό	ουσιαστικό	ουδέτερο, ενικός, κλητική
σημασίας	σημασία	ουσιαστικό	θηλυκό, ενικός, γενική
εικόνα	εικόνα	ουσιαστικό	θηλυκό, ενικός, κλητική
χάλι	χάλι	ουσιαστικό	, ενικός, κλητική
αδερφή	αδερφή	ουσιαστικό	θηλυκό, ενικός, κλητική
κόπο	κόπος	ουσιαστικό	αρσενικό, ενικός, αιτιατική
κόρη	κόρη	ουσιαστικό	θηλυκό, ενικός, κλητική
τραγούδι	τραγούδι	ουσιαστικό	ουδέτερο, ενικός, κλητική
ελαφρόπετρας	ελαφρόπετρα	ουσιαστικό	θηλυκό, ενικός, γενική
προτίμηση	προτίμηση	ουσιαστικό	θηλυκό, ενικός, κλητική
αθλητισμός	αθλητισμός	ουσιαστικό	αρσενικό, ενικός, ονομαστική
αναπαραστάσεις	αναπαράσταση	ουσιαστικό	θηλυκό, πληθυντικός, αιτιατική
χρόνων	χρόνος	ουσιαστικό	αρσενικό, πληθυντικός, γενική
πάγκου	πάγκος	ουσιαστικό	αρσενικό, ενικός, γενική
στεριάς	στεριά	ουσιαστικό	θηλυκό, ενικός, γενική
εμφάνιση	εμφάνιση	ουσιαστικό	θηλυκό, ενικός, κλητική
γέροντα	γέροντας	ουσιαστικό	αρσενικό, ενικός, κλητική
υπολείμματα	υπόλειμμα	ουσιαστικό	ουδέτερο, πληθυντικός, αιτιατική
ιώδιο	ιώδιο	ουσιαστικό	ουδέτερο, ενικός, κλητική
μπαστούνι	μπαστούνι	ουσιαστικό	ουδέτερο, ενικός, κλητική
κλάμα	κλάμα	ουσιαστικό	ουδέτερο, ενικός, κλητική
μάγουλο	μάγουλο	ουσιαστικό	ουδέτερο, ενικός, κλητική
πλώρη	πλώρη	ουσιαστικό	θηλυκό, ενικός, κλητική
πατρίδα	πατρίδα	ουσιαστικό	θηλυκό, ενικός, κλητική
ταύρο	ταύρος	ουσιαστικό	αρσενικό, ενικός, αιτιατική
καρβέλια	καρβέλι	ουσιαστικό	ουδέτερο, πληθυντικός, αιτιατική
χλαμύδα	χλαμύδα	ουσιαστικό	θηλυκό, ενικός, κλητική
λόγος	λόγος	ουσιαστικό	αρσενικό, ενικός, ονομαστική
τρέξιμο	τρέξιμο	ουσιαστικό	ουδέτερο, ενικός, κλητική
ερχομό	ερχομός	ουσιαστικό	αρσενικό, ενικός, αιτιατική
ατυχία	ατυχία	ουσιαστικό	θηλυκό, ενικός, κλητική
σχολείου	σχολείο	ουσιαστικό	ουδέτερο, ενικός, γενική
κατάσταση	κατάσταση	ουσιαστικό	θηλυκό, ενικός, κλητική
παρηγοριάς	παρηγοριά	ουσιαστικό	θηλυκό, ενικός, γενική
καθηγητής	καθηγητής	ουσιαστικό	αρσενικό, ενικός, ονομαστική
στέγες	στέγη	ουσιαστικό	θηλυκό, πληθυντικός, αιτιατική
θυμάρι	θυμάρι	ουσιαστικό	ουδέτερο, ενικός, κλητική
νύχια	νύχι	ουσιαστικό	ουδέτερο, πληθυντικός, αιτιατική
κάλεσμα	κάλεσμα	ουσιαστικό	ουδέτερο, ενικός, κλητική
υπολογιστής	υπολογιστής	ουσιαστικό	αρσενικό, ενικός, ονομαστική
γράμματα	γράμμα	ουσιαστικό	ουδέτερο, πληθυντικός, αιτιατική
οικογένεια	οικογένεια	ουσιαστικό	θηλυκό, ενικός, κλητική
σκόνη	σκόνη	ουσιαστικό	θηλυκό, ενικός, κλητική
αναγνώστης	αναγνώστης	ουσιαστικό	αρσενικό, ενικός, ονομαστική
οίστρος	οίστρος	ουσιαστικό	αρσενικό, ενικός, ονομαστική
κλόουν	κλόουν	ουσιαστικό	άκλιτο
όμηρος	όμηρος	ουσιαστικό	αρσενικό, ενικός, ονομαστική
επιστολές	επιστολή	ουσιαστικό	θηλυκό, πληθυντικός, αιτιατική
ώμους	ώμος	ουσιαστικό	αρσενικό, πληθυντικός, αιτιατική
κατήφορος	κατήφορος	ουσιαστικό	αρσενικό, ενικός, ονομαστική
λουρίδες	λουρίδα	ουσιαστικό	θηλυκό, πληθυντικός, αιτιατική
εγώ	εγώ	ουσιαστικό	άκλιτο
ωροσκόπιο	ωροσκόπιο	ουσιαστικό	ουδέτερο, ενικός, κλητική
έλεος	έλεος	ουσιαστικό	ουδέτερο, ενικός, κλητική
ουσία	ουσία	ουσιαστικό	θηλυκό, ενικός, κλητική
πλονζόν	πλονζόν	ουσιαστικό	άκλιτο
φούρνο	φούρνος	ουσιαστικό	αρσενικό, ενικός, αιτιατική
ομορφιά	ομορφιά	ουσιαστικό	θηλυκό, ενικός, κλητική
πέρδικα	πέρδικα	ουσιαστικό	θηλυκό, ενικός, κλητική
τέλος	τέλος	ουσιαστικό	ουδέτερο, ενικός, κλητική
περιοχή	περιοχή	ουσιαστικό	θηλυκό, ενικός, κλητική
παππούδες	παππούς	ουσιαστικό	αρσενικό, πληθυντικός, αιτιατική
παίκτες	παίκτης	ουσιαστικό	αρσενικό, πληθυντικός, αιτιατική
χρόνος	χρόνος	ουσιαστικό	αρσενικό, ενικός, ονομαστική
ακρόπολης	ακρόπολη	ουσιαστικό	θηλυκό, ενικός, γενική
τοποθεσίας	τοποθεσία	ουσιαστικό	θηλυκό, ενικός, γενική
πεδιάδα	πεδιάδα	ουσιαστικό	θηλυκό, ενικός, κλητική
μελίσσι	μελίσσι	ουσιαστικό	ουδέτερο, ενικός, κλητική
αριστουργήματα	αριστούργημα	ουσιαστικό	ουδέτερο, πληθυντικός, αιτιατική
βουητό	βουητό	ουσιαστικό	ουδέτερο, ενικός, κλητική
βρυχηθμό	βρυχηθμός	ουσιαστικό	αρσενικό, ενικός, αιτιατική
γδούποι	γδούπος	ουσιαστικό	αρσενικό, πληθυντικός, κλητική
παράπονο	παράπονο	ουσιαστικό	ουδέτερο, ενικός, κλητική
κοιλιάς	κοιλιά	ουσιαστικό	θηλυκό, ενικός, γενική
ίσκιους	ίσκιος	ουσιαστικό	αρσενικό, πληθυντικός, αιτιατική
δικαιολογία	δικαιολογία	ουσιαστικό	θηλυκό, ενικός, κλητική
προάστια	προάστιο	ουσιαστικό	ουδέτερο, πληθυντικός, αιτιατική
κούτσουρο	κούτσουρο	ουσιαστικό	ουδέτερο, ενικός, κλητική
γλώσσες	γλώσσα	ουσιαστικό	θηλυκό, πληθυντικός, αιτιατική
κούτσουρα	κούτσουρο	ουσιαστικό	ουδέτερο, πληθυντικός, αιτιατική
αποσπάσματα	απόσπασμα	ουσιαστικό	ουδέτερο, πληθυντικός, αιτιατική
ξανάνιωμα	ξανάνιωμα	ουσιαστικό	ουδέτερο, ενικός, κλητική
εξαίρεση	εξαίρεση	ουσιαστικό	θηλυκό, ενικός, κλητική
καραβιών	καράβι	ουσιαστικό	ουδέτερο, πληθυντικός, γενική
γειτονιά	γειτονιά	ουσιαστικό	θηλυκό, ενικός, κλητική
λόγγο	λόγγος	ουσιαστικό	αρσενικό, ενικός, αιτιατική
γυαλιά	γυαλί	ουσιαστικό	ουδέτερο, πληθυντικός, αιτιατική
βασίλισσα	βασίλισσα	ουσιαστικό	θηλυκό, ενικός, κλητική
δέντρα	δέντρο	ουσιαστικό	ουδέτερο, πληθυντικός, αιτιατική
τάσεων	τάση	ουσιαστικό	θηλυκό, πληθυντικός, γενική
κουφάλα	κουφάλα	ουσιαστικό	θηλυκό, ενικός, κλητική
δέντρο	δέντρο	ουσιαστικό	ουδέτερο, ενικός, κλητική
παπάς	παπάς	ουσιαστικό	αρσενικό, ενικός, ονομαστική
τοιχογραφίες	τοιχογραφία	ουσιαστικό	θηλυκό, πληθυντικός, αιτιατική
άγαλμα	άγαλμα	ουσιαστικό	ουδέτερο, ενικός, κλητική
ποικιλία	ποικιλία	ουσιαστικό	θηλυκό, ενικός, κλητική
βλέμμα	βλέμμα	ουσιαστικό	ουδέτερο, ενικός, κλητική
πλευρά	πλευρό	ουσιαστικό	ουδέτερο, πληθυντικός, αιτιατική
άμμο	άμμος	ουσιαστικό	θηλυκό, ενικός, κλητική
μεσημέρι	μεσημέρι	ουσιαστικό	ουδέτερο, ενικός, κλητική
στάση	στάση	ουσιαστικό	θηλυκό, ενικός, κλητική
στάρι	στάρι	ουσιαστικό	ουδέτερο, ενικός, κλητική
ψυχή	ψυχή	ουσιαστικό	θηλυκό, ενικός, κλητική
γκολ	γκολ	ουσιαστικό	άκλιτο
χέρι	χέρι	ουσιαστικό	ουδέτερο, ενικός, κλητική
σφάλμα	σφάλμα	ουσιαστικό	ουδέτερο, ενικός, κλητική
χασάπη	χασάπης	ουσιαστικό	αρσενικό, ενικός, κλητική
επιθυμιών	επιθυμία	ουσιαστικό	θηλυκό, πληθυντικός, γενική
βασίλειο	βασίλειο	ουσιαστικό	ουδέτερο, ενικός, κλητική
στόμα	στόμα	ουσιαστικό	ουδέτερο, ενικός, κλητική
γυμνασίου	γυμνάσια	ουσιαστικό	ουδέτερο, ενικός, γενική
μούτρα	μούτρο	ουσιαστικό	ουδέτερο, πληθυντικός, αιτιατική
χώρες	χώρα	ουσιαστικό	θηλυκό, πληθυντικός, αιτιατική
δουλειές	δουλειά	ουσιαστικό	θηλυκό, πληθυντικός, αιτιατική
θηρίων	θηρίο	ουσιαστικό	ουδέτερο, πληθυντικός, γενική
ελιγμό	ελιγμός	ουσιαστικό	αρσενικό, ενικός, αιτιατική
νικητής	νικητής	ουσιαστικό	αρσενικό, ενικός, ονομαστική
τσιμπούρια	τσιμπούρι	ουσιαστικό	ουδέτερο, πληθυντικός, αιτιατική
εξέδρα	εξέδρα	ουσιαστικό	θηλυκό, ενικός, κλητική
ζωγραφιά	ζωγραφιά	ουσιαστικό	θηλυκό, ενικός, κλητική
ζάρια	ζάρι	ουσιαστικό	ουδέτερο, πληθυντικός, αιτιατική
αλώνι	αλώνι	ουσιαστικό	ουδέτερο, ενικός, κλητική
βατομουριά	βατομουριά	ουσιαστικό	θηλυκό, ενικός, κλητική
σωρό	σωρός	ουσιαστικό	αρσενικό, ενικός, αιτιατική
πόρτα	πόρτο	ουσιαστικό	ουδέτερο, πληθυντικός, αιτιατική
ευτυχία	ευτυχία	ουσιαστικό	θηλυκό, ενικός, κλητική
περιηγητές	περιηγητής	ουσιαστικό	αρσενικό, πληθυντικός, αιτιατική
δουλειά	δουλειά	ουσιαστικό	θηλυκό, ενικός, κλητική
χορτάρι	χορτάρι	ουσιαστικό	ουδέτερο, ενικός, κλητική
διηγημάτων	διήγημα	ουσιαστικό	ουδέτερο, πληθυντικός, γενική
μάντρα	μάντρα	ουσιαστικό	θηλυκό, ενικός, κλητική
διακριτικότητα	διακριτικότητα	ουσιαστικό	θηλυκό, ενικός, κλητική
φορές	φορά	ουσιαστικό	θηλυκό, πληθυντικός, αιτιατική
χρονιάς	χρονιά	ουσιαστικό	θηλυκό, ενικός, γενική
χώρας	χώρα	ουσιαστικό	θηλυκό, ενικός, γενική
κανακέματα	κανάκεμα	ουσιαστικό	ουδέτερο, πληθυντικός, αιτιατική
χρόνο	χρόνος	ουσιαστικό	αρσενικό, ενικός, αιτιατική
τύμπανο	τύμπανο	ουσιαστικό	ουδέτερο, ενικός, κλητική
κάμπο	κάμπος	ουσιαστικό	αρσενικό, ενικός, αιτιατική
κατάνυξη	κατάνυξη	ουσιαστικό	θηλυκό, ενικός, κλητική
κείμενο	κείμενο	ουσιαστικό	ουδέτερο, ενικός, κλητική
φύσημα	φύσημα	ουσιαστικό	ουδέτερο, ενικός, κλητική
δωμάτιο	δωμάτιο	ουσιαστικό	ουδέτερο, ενικός, κλητική
αιτία	αιτία	ουσιαστικό	θηλυκό, ενικός, κλητική
μπάρα	μπάρα	ουσιαστικό	θηλυκό, ενικός, κλητική
συναισθήματα	συναίσθημα	ουσιαστικό	ουδέτερο, πληθυντικός, αιτιατική
βατομουριές	βατομουριά	ουσιαστικό	θηλυκό, πληθυντικός, αιτιατική
εκδίκηση	εκδίκηση	ουσιαστικό	θηλυκό, ενικός, κλητική
εποχή	εποχή	ουσιαστικό	θηλυκό, ενικός, κλητική
ζευγάρι	ζευγάρι	ουσιαστικό	ουδέτερο, ενικός, κλητική
κοντάρι	κοντάρι	ουσιαστικό	ουδέτερο, ενικός, κλητική
ζωή	ζωή	ουσιαστικό	θηλυκό, ενικός, κλητική
σιλουέτα	σιλουέτα	ουσιαστικό	θηλυκό, ενικός, κλητική
πασάς	πασάς	ουσιαστικό	αρσενικό, ενικός, ονομαστική
πατέρα	πατέρας	ουσιαστικό	αρσενικό, ενικός, κλητική
χάραμα	χάραμα	ουσιαστικό	ουδέτερο, ενικός, κλητική
θάλασσας	θάλασσα	ουσιαστικό	θηλυκό, ενικός, γενική
καιρούς	καιρός	ουσιαστικό	αρσενικό, πληθυντικός, αιτιατική
ζώα	ζώο	ουσιαστικό	ουδέτερο, πληθυντικός, αιτιατική
συνοδείας	συνοδεία	ουσιαστικό	θηλυκό, ενικός, γενική
ζωγραφική	ζωγραφική	ουσιαστικό	θηλυκό, ενικός, κλητική
κουρέλια	κουρέλι	ουσιαστικό	ουδέτερο, πληθυντικός, αιτιατική
σώμα	σώμα	ουσιαστικό	ουδέτερο, ενικός, κλητική
πουλιού	πουλί	ουσιαστικό	ουδέτερο, ενικός, γενική
χιτώνα	χιτώνας	ουσιαστικό	αρσενικό, ενικός, κλητική
χειμώνα	χειμώνας	ουσιαστικό	αρσενικό, ενικός, κλητική
λεπτομέρειες	λεπτομέρεια	ουσιαστικό	θηλυκό, πληθυντικός, αιτιατική
πολιτεία	πολιτεία	ουσιαστικό	θηλυκό, ενικός, κλητική
φανέλες	φανέλα	ουσιαστικό	θηλυκό, πληθυντικός, αιτιατική
στόχο	στόχος	ουσιαστικό	αρσενικό, ενικός, αιτιατική
ζώο	ζώο	ουσιαστικό	ουδέτερο, ενικός, κλητική
τεράτων	τέρας	ουσιαστικό	ουδέτερο, πληθυντικός, γενική
πάθους	πάθος	ουσιαστικό	ουδέτερο, ενικός, γενική
αγωνία	αγωνία	ουσιαστικό	θηλυκό, ενικός, κλητική
αποφόρι	αποφόρι	ουσιαστικό	ουδέτερο, ενικός, κλητική
στέρνα	στέρνο	ουσιαστικό	ουδέτερο, πληθυντικός, αιτιατική
προσταγή	προσταγή	ουσιαστικό	θηλυκό, ενικός, κλητική
ρήγας	ρήγας	ουσιαστικό	αρσενικό, ενικός, ονομαστική
παλάτι	παλάτι	ουσιαστικό	ουδέτερο, ενικός, κλητική
ομάδα	ομάδα	ουσιαστικό	θηλυκό, ενικός, κλητική
χέλι	χέλι	ουσιαστικό	ουδέτερο, ενικός, κλητική
πέναλτι	πέναλτι	ουσιαστικό	άκλιτο
φύσης	φύση	ουσιαστικό	θηλυκό, ενικός, γενική
διάθεση	διάθεση	ουσιαστικό	θηλυκό, ενικός, κλητική
εστία	εστία	ουσιαστικό	θηλυκό, ενικός, κλητική
ανορεξιά	ανορεξιά	ουσιαστικό	θηλυκό, ενικός, κλητική
αποτέλεσμα	αποτέλεσμα	ουσιαστικό	ουδέτερο, ενικός, κλητική
κατηφοριά	κατηφοριά	ουσιαστικό	θηλυκό, ενικός, κλητική
λεπτομερειών	λεπτομέρεια	ουσιαστικό	θηλυκό, πληθυντικός, γενική
χαμόγελο	χαμόγελο	ουσιαστικό	ουδέτερο, ενικός, κλητική
πόλεμο	πόλεμος	ουσιαστικό	αρσενικό, ενικός, αιτιατική
βεράντας	βεράντα	ουσιαστικό	θηλυκό, ενικός, γενική
στεναχώρια	στεναχώρια	ουσιαστικό	θηλυκό, ενικός, κλητική
γνώσεις	γνώση	ουσιαστικό	θηλυκό, πληθυντικός, αιτιατική
επαναστάσεως	επανάσταση	ουσιαστικό	θηλυκό, ενικός, γενική
περιπέτειες	περιπέτεια	ουσιαστικό	θηλυκό, πληθυντικός, αιτιατική
ζαβολιά	ζαβολιά	ουσιαστικό	θηλυκό, ενικός, κλητική
ουρά	ουρά	ουσιαστικό	θηλυκό, ενικός, κλητική
φάουλ	φάουλ	ουσιαστικό	άκλιτο
άνοιξη	άνοιξη	ουσιαστικό	θηλυκό, ενικός, κλητική
σπιτιών	σπίτι	ουσιαστικό	ουδέτερο, πληθυντικός, γενική
αρμυρίκια	αρμυρίκι	ουσιαστικό	ουδέτερο, πληθυντικός, αιτιατική
σπίτι	σπίτι	ουσιαστικό	ουδέτερο, ενικός, κλητική
μπάλα	μπάλα	ουσιαστικό	θηλυκό, ενικός, κλητική
ενδιαίτημα	ενδιαίτημα	ουσιαστικό	ουδέτερο, ενικός, κλητική
εδάφους	έδαφος	ουσιαστικό	ουδέτερο, ενικός, γενική
πόλεις	πόλη	ουσιαστικό	θηλυκό, πληθυντικός, αιτιατική
κήποι	κήπος	ουσιαστικό	αρσενικό, πληθυντικός, κλητική
διατάξεις	διάταξη	ουσιαστικό	θηλυκό, πληθυντικός, αιτιατική
ναυαγό	ναυαγός	ουσιαστικό	αρσενικό, ενικός, αιτιατική
ευχές	ευχή	ουσιαστικό	θηλυκό, πληθυντικός, αιτιατική
ύπαρξη	ύπαρξη	ουσιαστικό	θηλυκό, ενικός, κλητική
αγροί	αγρός	ουσιαστικό	αρσενικό, πληθυντικός, κλητική
κερκίδας	κερκίδα	ουσιαστικό	θηλυκό, ενικός, γενική
τσουβάλι	τσουβάλι	ουσιαστικό	ουδέτερο, ενικός, κλητική
αυτοκρατορίας	αυτοκρατορία	ουσιαστικό	θηλυκό, ενικός, γενική
φαμελιά	φαμελιά	ουσιαστικό	θηλυκό, ενικός, κλητική
πύλης	πύλη	ουσιαστικό	θηλυκό, ενικός, γενική
στοιχεία	στοιχείο	ουσιαστικό	ουδέτερο, πληθυντικός, αιτιατική
βροχή	βροχή	ουσιαστικό	θηλυκό, ενικός, κλητική
φόβο	φόβος	ουσιαστικό	αρσενικό, ενικός, αιτιατική
πού	που	ουσιαστικό	άκλιτο
που	που	ουσιαστικό	άκλιτο
μαρμελάδα	μαρμελάδα	ουσιαστικό	θηλυκό, ενικός, κλητική
φόρτυ	φόρτι	ουσιαστικό	ουδέτερο, ενικός, κλητική
γρατσουνιά	γρατσουνιά	ουσιαστικό	θηλυκό, ενικός, κλητική
κορυφή	κορυφή	ουσιαστικό	θηλυκό, ενικός, κλητική
μάντρες	μάντρα	ουσιαστικό	θηλυκό, πληθυντικός, αιτιατική
ζόρι	ζόρι	ουσιαστικό	, ενικός, κλητική
μουρμουρητό	μουρμουρητό	ουσιαστικό	ουδέτερο, ενικός, κλητική
εξόντωση	εξόντωση	ουσιαστικό	θηλυκό, ενικός, κλητική
σκοινί	σκοινί	ουσιαστικό	ουδέτερο, ενικός, κλητική
μάγος	μάγος	ουσιαστικό	αρσενικό, ενικός, ονομαστική
θέαμα	θέαμα	ουσιαστικό	ουδέτερο, ενικός, κλητική
γαλήνη	γαλήνη	ουσιαστικό	θηλυκό, ενικός, κλητική
φεγγάρι	φεγγάρι	ουσιαστικό	ουδέτερο, ενικός, κλητική
γαρουφαλιά	γαρουφαλιά	ουσιαστικό	θηλυκό, ενικός, κλητική
υπομονή	υπομονή	ουσιαστικό	θηλυκό, ενικός, κλητική
μήνες	μήνας	ουσιαστικό	αρσενικό, πληθυντικός, αιτιατική
έκφραση	έκφραση	ουσιαστικό	θηλυκό, ενικός, κλητική
επίπεδο	επίπεδο	ουσιαστικό	ουδέτερο, ενικός, κλητική
αυτοτέλεια	αυτοτέλεια	ουσιαστικό	θηλυκό, ενικός, κλητική
γείτονες	γείτονας	ουσιαστικό	αρσενικό, πληθυντικός, αιτιατική
σημείου	σημείο	ουσιαστικό	ουδέτερο, ενικός, γενική
μπρετέλες	μπρετέλα	ουσιαστικό	θηλυκό, πληθυντικός, αιτιατική
ονειροπόληση	ονειροπόληση	ουσιαστικό	θηλυκό, ενικός, κλητική
κύπελλο	κύπελλο	ουσιαστικό	ουδέτερο, ενικός, κλητική
χέρια	χέρι	ουσιαστικό	ουδέτερο, πληθυντικός, αιτιατική
πλήθος	πλήθος	ουσιαστικό	ουδέτερο, ενικός, κλητική
λάθος	λάθος	ουσιαστικό	ουδέτερο, ενικός, κλητική
παιδιά	παιδί	ουσιαστικό	ουδέτερο, πληθυντικός, αιτιατική
χορούς	χορός	ουσιαστικό	αρσενικό, πληθυντικός, αιτιατική
αδερφής	αδερφή	ουσιαστικό	θηλυκό, ενικός, γενική
προσώπων	πρόσωπο	ουσιαστικό	ουδέτερο, πληθυντικός, γενική
αμφιέσεων	αμφίεση	ουσιαστικό	θηλυκό, πληθυντικός, γενική
παραδείγματα	παράδειγμα	ουσιαστικό	ουδέτερο, πληθυντικός, αιτιατική
βεράντες	βεράντα	ουσιαστικό	θηλυκό, πληθυντικός, αιτιατική
σπιτιού	σπίτι	ουσιαστικό	ουδέτερο, ενικός, γενική
σπίτια	σπίτι	ουσιαστικό	ουδέτερο, πληθυντικός, αιτιατική
έλεγχο	έλεγχος	ουσιαστικό	αρσενικό, ενικός, αιτιατική
επεισόδιο	επεισόδιο	ουσιαστικό	ουδέτερο, ενικός, κλητική
σκύλους	σκύλος	ουσιαστικό	αρσενικό, πληθυντικός, αιτιατική
σαρανταριά	σαρανταριά	ουσιαστικό	θηλυκό, ενικός, κλητική
βαθμούς	βαθμός	ουσιαστικό	αρσενικό, πληθυντικός, αιτιατική
αυτιά	αυτί	ουσιαστικό	ουδέτερο, πληθυντικός, αιτιατική
επεισόδια	επεισόδιο	ουσιαστικό	ουδέτερο, πληθυντικός, αιτιατική
αρένες	αρένα	ουσιαστικό	θηλυκό, πληθυντικός, αιτιατική
αυγούστου	αύγουστος	ουσιαστικό	αρσενικό, ενικός, γενική
κοτσάνι	κοτσάνι	ουσιαστικό	ουδέτερο, ενικός, κλητική
βούλες	βούλα	ουσιαστικό	θηλυκό, πληθυντικός, αιτιατική
