θύμωσε	θυμώνω	ρήμα	ενεργητική, αόριστος, οριστική, ενικός, 3ο πρόσωπο
ταξίδι	ταξίδι	ουσιαστικό	ουδέτερο, ενικός, κλητική
φανάρι	φανάρι	ουσιαστικό	ουδέτερο, ενικός, κλητική
βάθη	βάθος	ουσιαστικό	ουδέτερο, πληθυντικός, αιτιατική
λιτότητα	λιτότητα	ουσιαστικό	θηλυκό, ενικός, κλητική
συνέχιζε	συνεχίζω	ρήμα	ενεργητική, παρατατικός, οριστική, ενικός, 3ο πρόσωπο
νερά	νερό	ουσιαστικό	ουδέτερο, πληθυντικός, αιτιατική
κουκουβάγια	κουκουβάγια	ουσιαστικό	θηλυκό, ενικός, κλητική
μεγάλωνε	μεγαλώνω	ρήμα	ενεργητική, παρατατικός, οριστική, ενικός, 3ο πρόσωπο
βάζο	βάζο	ουσιαστικό	ουδέτερο, ενικός, κλητική
ζητά	ζητάς	ουσιαστικό	αρσενικό, ενικός, κλητική
χαμηλή	χαμηλός	επίθετο	θηλυκό, ενικός, ονομαστική
χαμηλά	χαμηλός	επίθετο	ουδέτερο, πληθυντικός, αιτιατική
εκπρόσωπο	εκπρόσωπος	ουσιαστικό	αρσενικό, ενικός, αιτιατική
δέκα	δέκα	επίθετο	άκλιτο
ποταμού	ποταμός	ουσιαστικό	αρσενικό, ενικός, γενική
κάποτε	κάποτε	επίρρημα	
μερικά	μερικός	επίθετο	ουδέτερο, πληθυντικός, αιτιατική
πουκάμισα	πουκάμισο	ουσιαστικό	ουδέτερο, πληθυντικός, αιτιατική
πρόσεχε	προσέχω	ρήμα	ενεργητική, παρατατικός, οριστική, ενικός, 3ο πρόσωπο
ερευνητή	ερευνητής	ουσιαστικό	αρσενικό, ενικός, κλητική
σακί	σακί	ουσιαστικό	ουδέτερο, ενικός, κλητική
πανάγαθος	πανάγαθος	ουσιαστικό	αρσενικό, ενικός, ονομαστική
τεντώθηκε	τεντώνω	ρήμα	παθητική, αόριστος, οριστική, ενικός, 3ο πρόσωπο
συνηθίσει	συνηθίζω	ρήμα	ενεργητική, αόριστος, υποτακτική, ενικός, 3ο πρόσωπο
φωνή	φωνή	ουσιαστικό	θηλυκό, ενικός, κλητική
λείπει	λείπω	ρήμα	ενεργητική, ενεστώτας, οριστική, ενικός, 3ο πρόσωπο
κεντούσε	κεντώ	ρήμα	ενεργητική, παρατατικός, οριστική, ενικός, 3ο πρόσωπο
φιλί	φιλί	ουσιαστικό	ουδέτερο, ενικός, κλητική
γηπέδου	γήπεδο	ουσιαστικό	ουδέτερο, ενικός, γενική
γόνατα	γόνατο	ουσιαστικό	ουδέτερο, πληθυντικός, αιτιατική
ταραχώδη	ταραχώδης	επίθετο	θηλυκό, ενικός, αιτιατική
κανονικό	κανονικός	επίθετο	αρσενικό, ενικός, αιτιατική
αγελάδα	αγελάδα	ουσιαστικό	θηλυκό, ενικός, κλητική
λούσα	λούσο	ουσιαστικό	ουδέτερο, πληθυντικός, αιτιατική
βήματα	βήμα	ουσιαστικό	ουδέτερο, πληθυντικός, αιτιατική
βήματα	βήμα	ουσιαστικό	ουδέτερο, πληθυντικός, αιτιατική
ξαναγυρίζω	ξαναγυρίζω	ρήμα	ενεργητική, ενεστώτας, οριστική, ενικός, 1ο πρόσωπο
παλικάρι	παλικάρι	ουσιαστικό	ουδέτερο, ενικός, κλητική
γαλήνια	γαλήνιος	επίθετο	θηλυκό, ενικός, ονομαστική
απόλυτο	απόλυτος	επίθετο	αρσενικό, ενικός, αιτιατική
βαραίνει	βαραίνω	ρήμα	ενεργητική, ενεστώτας, οριστική, ενικός, 3ο πρόσωπο
κοιμήθηκε	κοιμούμαι	ρήμα	παθητική, αόριστος, οριστική, ενικός, 3ο πρόσωπο
κατηγορούσαν	κατηγορώ	ρήμα	ενεργητική, παρατατικός, οριστική, πληθυντικός, 3ο πρόσωπο
κανένα	κανένας	 αντωνυμία	 αρσενικό, αόριστη, ενικός, αιτιατική
κοριτσιού	κορίτσι	ουσιαστικό	ουδέτερο, ενικός, γενική
φωνάζει	φωνάζω	ρήμα	ενεργητική, ενεστώτας, οριστική, ενικός, 3ο πρόσωπο
χωράφι	χωράφι	ουσιαστικό	ουδέτερο, ενικός, κλητική
κατατρόμαξε	κατατρομάζω	ρήμα	ενεργητική, αόριστος, οριστική, ενικός, 3ο πρόσωπο
απόλυτη	απόλυτος	επίθετο	θηλυκό, ενικός, ονομαστική
απόλυτα	απόλυτος	επίθετο	ουδέτερο, πληθυντικός, αιτιατική
τελετουργικά	τελετουργικός	επίθετο	ουδέτερο, πληθυντικός, αιτιατική
φρόνιμη	φρόνιμος	επίθετο	θηλυκό, ενικός, ονομαστική
χελωνίτσες	χελωνίτσα	 ουσιαστικό	 θηλυκό, πληθυντικός, ονομαστική, αιτιατική, κλητική
κατευθύνονται	κατευθύνω	ρήμα	παθητική, ενεστώτας, οριστική, πληθυντικός, 3ο πρόσωπο
χρώματα	χρώμα	ουσιαστικό	ουδέτερο, πληθυντικός, αιτιατική
μιλούσαν	μιλώ	ρήμα	ενεργητική, παρατατικός, οριστική, πληθυντικός, 3ο πρόσωπο
μερικές	μερικός	επίθετο	θηλυκό, πληθυντικός, ονομαστική
διατηρεί	διατηρώ	ρήμα	ενεργητική, ενεστώτας, οριστική, ενικός, 3ο πρόσωπο
μουγκανίζετε	μουγκανίζω	ρήμα	ενεργητική, ενεστώτας, προστακτική, πληθυντικός, 2ο πρόσωπο
πρόσεξε	προσέχω	ρήμα	ενεργητική, αόριστος, οριστική, ενικός, 3ο πρόσωπο
μάνα	μάνα	ουσιαστικό	θηλυκό, ενικός, κλητική
κάτοικοι	κάτοικος	ουσιαστικό	αρσενικό, πληθυντικός, κλητική
μάθημα	μάθημα	ουσιαστικό	ουδέτερο, ενικός, κλητική
μάτι	μάτι	ουσιαστικό	ουδέτερο, ενικός, κλητική
συνέχισε	συνεχίζω	ρήμα	ενεργητική, αόριστος, οριστική, ενικός, 3ο πρόσωπο
χαλίκια	χαλίκι	ουσιαστικό	ουδέτερο, πληθυντικός, αιτιατική
φανεί	φαίνομαι	 ρήμα	 παθητική, αόριστος β, υποτακτική, ενικός, 3ο πρόσωπο
ορθώθηκε	ορθώνω	ρήμα	παθητική, αόριστος, οριστική, ενικός, 3ο πρόσωπο
κουράζεσαι	κουράζω	ρήμα	παθητική, ενεστώτας, οριστική, ενικός, 2ο πρόσωπο
πενήντα	πενήντα	επίθετο	άκλιτο
παράλογη	παράλογος	επίθετο	θηλυκό, ενικός, ονομαστική
μπουμπουκιών	μπουμπούκι	ουσιαστικό	ουδέτερο, πληθυντικός, γενική
πίσω	πίσω	επίρρημα	
ζωντανά	ζωντανός	επίθετο	ουδέτερο, πληθυντικός, αιτιατική
σειρά	σειρά	ουσιαστικό	θηλυκό, ενικός, κλητική
μπορέσεις	μπορώ	ρήμα	ενεργητική, αόριστος, υποτακτική, ενικός, 2ο πρόσωπο
σακούλες	σακούλα	ουσιαστικό	θηλυκό, πληθυντικός, αιτιατική
ποτάμι	ποτάμι	ουσιαστικό	ουδέτερο, ενικός, κλητική
παίζει	παίζω	ρήμα	ενεργητική, ενεστώτας, οριστική, ενικός, 3ο πρόσωπο
ταραχή	ταραχή	ουσιαστικό	θηλυκό, ενικός, κλητική
τύποι	τύπος	ουσιαστικό	αρσενικό, πληθυντικός, κλητική
γείτονα	γείτονας	ουσιαστικό	αρσενικό, ενικός, κλητική
σηκώθηκε	σηκώνω	ρήμα	παθητική, αόριστος, οριστική, ενικός, 3ο πρόσωπο
ταρακουνώντας	ταρακουνώ	ρήμα	ενεργητική, ενεστώτας, μετοχή, , 
τύλιξε	τυλίγω	ρήμα	ενεργητική, αόριστος, οριστική, ενικός, 3ο πρόσωπο
στριφογύρισε	στριφογυρίζω	ρήμα	ενεργητική, αόριστος, οριστική, ενικός, 3ο πρόσωπο
μυθιστόρημα	μυθιστόρημα	ουσιαστικό	ουδέτερο, ενικός, κλητική
ταχύτητα	ταχύτητα	ουσιαστικό	θηλυκό, ενικός, κλητική
φανέλας	φανέλα	ουσιαστικό	θηλυκό, ενικός, γενική
μητέρα	μητέρα	ουσιαστικό	θηλυκό, ενικός, κλητική
ψέματα	ψέμα	ουσιαστικό	ουδέτερο, πληθυντικός, αιτιατική
όνομα	όνομα	ουσιαστικό	ουδέτερο, ενικός, κλητική
δεξί	δεξής	επίθετο	ουδέτερο, ενικός, αιτιατική
ματάκια	ματάκιας	ουσιαστικό	αρσενικό, ενικός, κλητική
δειλά	δειλός	επίθετο	ουδέτερο, πληθυντικός, αιτιατική
κουβάλησε	κουβαλώ	ρήμα	ενεργητική, αόριστος, οριστική, ενικός, 3ο πρόσωπο
πιτσιρικάς	πιτσιρικάς	ουσιαστικό	αρσενικό, ενικός, ονομαστική
πασά	πασάς	ουσιαστικό	αρσενικό, ενικός, κλητική
μεταχειρίζονται	μεταχειρίζομαι	ρήμα	παθητική, ενεστώτας, οριστική, πληθυντικός, 3ο πρόσωπο
παπά	παπάς	ουσιαστικό	αρσενικό, ενικός, κλητική
τούτα	τούτος	 αντωνυμία	 ουδέτερο, δεικτική, πληθυντικός, ονομαστική, αιτιατική
μύτη	μύτη	ουσιαστικό	θηλυκό, ενικός, κλητική
μαλακά	μαλακός	επίθετο	ουδέτερο, πληθυντικός, αιτιατική
παρά	παράς	ουσιαστικό	αρσενικό, ενικός, κλητική
ευχαριστώ	ευχαριστώ	ρήμα	ενεργητική, ενεστώτας, οριστική, ενικός, 1ο πρόσωπο
παπα	πάπας	ουσιαστικό	αρσενικό, ενικός, κλητική
ξύλινους	ξύλινος	επίθετο	αρσενικό, πληθυντικός, αιτιατική
μπόρεσε	μπορώ	ρήμα	ενεργητική, αόριστος, οριστική, ενικός, 3ο πρόσωπο
μπόρεσα	μπορώ	ρήμα	ενεργητική, αόριστος, οριστική, ενικός, 1ο πρόσωπο
καταντήσουν	καταντώ	ρήμα	ενεργητική, αόριστος, υποτακτική, πληθυντικός, 3ο πρόσωπο
συνεχίσω	συνεχίζω	ρήμα	ενεργητική, αόριστος, υποτακτική, ενικός, 1ο πρόσωπο
περιορίζεται	περιορίζω	ρήμα	παθητική, ενεστώτας, οριστική, ενικός, 3ο πρόσωπο
συμπεριφορές	συμπεριφορά	ουσιαστικό	θηλυκό, πληθυντικός, αιτιατική
σιμά	σιμά	επίρρημα	
ψαράδες	ψαράς	ουσιαστικό	αρσενικό, πληθυντικός, αιτιατική
βάδιζε	βαδίζω	ρήμα	ενεργητική, παρατατικός, οριστική, ενικός, 3ο πρόσωπο
δάγκωμα	δάγκωμα	ουσιαστικό	ουδέτερο, ενικός, κλητική
ζήλεψα	ζηλεύω	ρήμα	ενεργητική, αόριστος, οριστική, ενικός, 1ο πρόσωπο
τύχη	τύχη	ουσιαστικό	θηλυκό, ενικός, κλητική
σωματικά	σωματικός	επίθετο	ουδέτερο, πληθυντικός, αιτιατική
συνετή	συνετός	επίθετο	θηλυκό, ενικός, ονομαστική
γαλανό	γαλανός	επίθετο	αρσενικό, ενικός, αιτιατική
διαλαλεί	διαλαλώ	ρήμα	ενεργητική, ενεστώτας, οριστική, ενικός, 3ο πρόσωπο
παίζανε	παίζω	ρήμα	ενεργητική, παρατατικός, οριστική, πληθυντικός, 3ο πρόσωπο
τάχα	τάχα	επίρρημα	
λάδι	λάδι	ουσιαστικό	ουδέτερο, ενικός, κλητική
τζαμί	τζαμί	ουσιαστικό	ουδέτερο, ενικός, κλητική
κατοικούν	κατοικώ	ρήμα	ενεργητική, ενεστώτας, οριστική, πληθυντικός, 3ο πρόσωπο
μύλο	μύλος	ουσιαστικό	αρσενικό, ενικός, αιτιατική
κινήσεις	κίνηση	ουσιαστικό	θηλυκό, πληθυντικός, αιτιατική
βουτήξει	βουτάω	ρήμα	ενεργητική, αόριστος, υποτακτική, ενικός, 3ο πρόσωπο
παρακαλώ	παρακαλώ	ρήμα	ενεργητική, ενεστώτας, οριστική, ενικός, 1ο πρόσωπο
πανταλόνι	πανταλόνι	ουσιαστικό	ουδέτερο, ενικός, κλητική
δείξω	δείχνω	ρήμα	ενεργητική, αόριστος, υποτακτική, ενικός, 1ο πρόσωπο
κοίταξε	κοιτάζω	ρήμα	ενεργητική, αόριστος, οριστική, ενικός, 3ο πρόσωπο
φυσικό	φυσικός	επίθετο	αρσενικό, ενικός, αιτιατική
κοίταξα	κοιτάζω	ρήμα	ενεργητική, αόριστος, οριστική, ενικός, 1ο πρόσωπο
δείξε	δείχνω	ρήμα	ενεργητική, αόριστος, προστακτική, ενικός, 2ο πρόσωπο
παραμύθι	παραμύθι	ουσιαστικό	ουδέτερο, ενικός, κλητική
ευγενικά	ευγενικός	επίθετο	ουδέτερο, πληθυντικός, αιτιατική
φυσικά	φυσικός	επίθετο	ουδέτερο, πληθυντικός, αιτιατική
ευγενική	ευγενικός	επίθετο	θηλυκό, ενικός, ονομαστική
δυνάμεις	δυνάμεις	ουσιαστικό	θηλυκό, πληθυντικός, αιτιατική
μοναδική	μοναδικός	επίθετο	θηλυκό, ενικός, ονομαστική
παρατηρούσε	παρατηρώ	ρήμα	ενεργητική, παρατατικός, οριστική, ενικός, 3ο πρόσωπο
βασιλικής	βασιλικός	επίθετο	θηλυκό, ενικός, γενική
παζάρια	παζάρι	ουσιαστικό	ουδέτερο, πληθυντικός, αιτιατική
μοναδικό	μοναδικός	επίθετο	αρσενικό, ενικός, αιτιατική
ζυμάρι	ζυμάρι	ουσιαστικό	ουδέτερο, ενικός, κλητική
μωρού	μωρός	επίθετο	ουδέτερο, ενικός, γενική
σώματα	σώμα	ουσιαστικό	ουδέτερο, πληθυντικός, αιτιατική
φανατικός	φανατικός	επίθετο	αρσενικό, ενικός, ονομαστική
φαινομενικά	φαινομενικός	επίθετο	ουδέτερο, πληθυντικός, αιτιατική
γενική	γενικός	επίθετο	θηλυκό, ενικός, ονομαστική
γέμισε	γεμίζω	ρήμα	ενεργητική, αόριστος, οριστική, ενικός, 3ο πρόσωπο
βυζαντινός	βυζαντινός	επίθετο	αρσενικό, ενικός, ονομαστική
φάλαινα	φάλαινα	ουσιαστικό	θηλυκό, ενικός, κλητική
βήξιμο	βήξιμο	ουσιαστικό	ουδέτερο, ενικός, κλητική
λυρικός	λυρικός	επίθετο	αρσενικό, ενικός, ονομαστική
μέσα	μέσος	επίθετο	ουδέτερο, πληθυντικός, αιτιατική
φανάρια	φανάρι	ουσιαστικό	ουδέτερο, πληθυντικός, αιτιατική
μέρα	μέρα	ουσιαστικό	θηλυκό, ενικός, κλητική
μισοκακόμοιρο	μισοκακόμοιρος	επίθετο	αρσενικό, ενικός, αιτιατική
παπούτσια	παπούτσι	ουσιαστικό	ουδέτερο, πληθυντικός, αιτιατική
καλά	καλό	ουσιαστικό	ουδέτερο, πληθυντικός, αιτιατική
καλέ	καλέ	επιφώνημα	
καλή	καλός	 επίθετο	 θηλυκό, θετικός, ενικός, ονομαστική, αιτιατική, κλητική
κυνηγό	κυνηγός	ουσιαστικό	αρσενικό, ενικός, αιτιατική
πέσιμο	πέσιμο	ουσιαστικό	ουδέτερο, ενικός, κλητική
τρόμαξα	τρομάζω	ρήμα	ενεργητική, αόριστος, οριστική, ενικός, 1ο πρόσωπο
μέση	μέσος	επίθετο	θηλυκό, ενικός, ονομαστική
μεγαλόφωνα	μεγαλόφωνος	επίθετο	ουδέτερο, πληθυντικός, αιτιατική
φόρεμα	φόρεμα	ουσιαστικό	ουδέτερο, ενικός, κλητική
κοιτάζοντας	κοιτάζω	ρήμα	ενεργητική, ενεστώτας, μετοχή, , 
προχώρησε	προχωρώ	ρήμα	ενεργητική, αόριστος, οριστική, ενικός, 3ο πρόσωπο
σωτήρας	σωτήρας	ουσιαστικό	αρσενικό, ενικός, ονομαστική
ψηλά	ψηλός	επίθετο	ουδέτερο, πληθυντικός, αιτιατική
κακά	κακός	επίθετο	ουδέτερο, πληθυντικός, αιτιατική
μετά	μετά	πρόθεση	
δυνατός	δυνατός	επίθετο	αρσενικό, ενικός, ονομαστική
μπορούσανε	μπορώ	ρήμα	ενεργητική, παρατατικός, οριστική, πληθυντικός, 3ο πρόσωπο
παγωτά	παγωτό	ουσιαστικό	ουδέτερο, πληθυντικός, αιτιατική
μπορούσαμε	μπορώ	ρήμα	ενεργητική, παρατατικός, οριστική, πληθυντικός, 1ο πρόσωπο
παγωτό	παγωτό	ουσιαστικό	ουδέτερο, ενικός, κλητική
μύριζε	μυρίζω	ρήμα	ενεργητική, παρατατικός, οριστική, ενικός, 3ο πρόσωπο
αγριεμένα	αγριεμένος	επίθετο	ουδέτερο, πληθυντικός, αιτιατική
χαρούμενα	χαρούμενος	επίθετο	ουδέτερο, πληθυντικός, αιτιατική
αγριεμένη	αγριεμένος	επίθετο	θηλυκό, ενικός, ονομαστική
αγριεμένο	αγριεμένος	επίθετο	αρσενικό, ενικός, αιτιατική
γαλάζιας	γαλάζιος	επίθετο	θηλυκό, ενικός, γενική
παίξουμε	παίζω	ρήμα	ενεργητική, αόριστος, υποτακτική, πληθυντικός, 1ο πρόσωπο
φήμη	φήμη	ουσιαστικό	θηλυκό, ενικός, κλητική
σφοδρότητα	σφοδρότητα	ουσιαστικό	θηλυκό, ενικός, κλητική
χαρούμενο	χαρούμενος	επίθετο	αρσενικό, ενικός, αιτιατική
παρακόρες	παρακόρη	ουσιαστικό	θηλυκό, πληθυντικός, αιτιατική
χωρίσουν	χωρίζω	ρήμα	ενεργητική, αόριστος, υποτακτική, πληθυντικός, 3ο πρόσωπο
φυλάμε	φυλάω	ρήμα	ενεργητική, ενεστώτας, οριστική, πληθυντικός, 1ο πρόσωπο
κόκαλο	κόκαλο	ουσιαστικό	ουδέτερο, ενικός, κλητική
σοβαρές	σοβαρός	επίθετο	θηλυκό, πληθυντικός, ονομαστική
κατά	κατά	πρόθεση	
δάγκωσε	δαγκώνω	ρήμα	ενεργητική, αόριστος, οριστική, ενικός, 3ο πρόσωπο
σημερινή	σημερινός	επίθετο	θηλυκό, ενικός, ονομαστική
φόρεσε	φορώ	ρήμα	ενεργητική, αόριστος, οριστική, ενικός, 3ο πρόσωπο
γέμιζε	γεμίζω	ρήμα	ενεργητική, παρατατικός, οριστική, ενικός, 3ο πρόσωπο
μαλακό	μαλακός	επίθετο	αρσενικό, ενικός, αιτιατική
κόκαλα	κόκαλο	ουσιαστικό	ουδέτερο, πληθυντικός, αιτιατική
χαράματα	χάραμα	ουσιαστικό	ουδέτερο, πληθυντικός, αιτιατική
πούλησε	πουλάω	ρήμα	ενεργητική, αόριστος, οριστική, ενικός, 3ο πρόσωπο
συνήθεια	συνήθειο	ουσιαστικό	ουδέτερο, πληθυντικός, αιτιατική
περιεχόμενο	περιεχόμενο	ουσιαστικό	ουδέτερο, ενικός, κλητική
παίξει	παίζω	ρήμα	ενεργητική, αόριστος, υποτακτική, ενικός, 3ο πρόσωπο
μένα	εγώ	 αντωνυμία	 προσωπική, 1ο πρόσωπο, ενικός, γενική, αιτιατική
κολύμπησε	κολυμπώ	ρήμα	ενεργητική, αόριστος, οριστική, ενικός, 3ο πρόσωπο
σιγά	σιγά	επίρρημα	
φυλάξει	φυλάσσω	ρήμα	ενεργητική, αόριστος, υποτακτική, ενικός, 3ο πρόσωπο
κακού	κακός	επίθετο	ουδέτερο, ενικός, γενική
αδιαφορεί	αδιαφορώ	ρήμα	ενεργητική, ενεστώτας, οριστική, ενικός, 3ο πρόσωπο
μεγαλώνει	μεγαλώνω	ρήμα	ενεργητική, ενεστώτας, οριστική, ενικός, 3ο πρόσωπο
δοκίμασες	δοκιμάζω	ρήμα	ενεργητική, αόριστος, οριστική, ενικός, 2ο πρόσωπο
θέμα	θέμα	ουσιαστικό	ουδέτερο, ενικός, κλητική
φίλο	φίλος	επίθετο	αρσενικό, ενικός, αιτιατική
φίλε	φίλος	επίθετο	αρσενικό, ενικός, κλητική
φίλη	φίλος	επίθετο	θηλυκό, ενικός, ονομαστική
δυτικό	δυτικός	επίθετο	αρσενικό, ενικός, αιτιατική
φανερό	φανερός	επίθετο	αρσενικό, ενικός, αιτιατική
ζάρωσε	ζαρώνω	ρήμα	ενεργητική, αόριστος, οριστική, ενικός, 3ο πρόσωπο
θυμάται	θυμούμαι	ρήμα	παθητική, ενεστώτας, οριστική, ενικός, 3ο πρόσωπο
τύχη	τύχη	ουσιαστικό	θηλυκό, ενικός, κλητική
λιοπύρι	λιοπύρι	ουσιαστικό	ουδέτερο, ενικός, κλητική
πρόθεση	πρόθεση	ουσιαστικό	θηλυκό, ενικός, κλητική
κήπο	κήπος	ουσιαστικό	αρσενικό, ενικός, αιτιατική
δυτική	δυτικός	επίθετο	θηλυκό, ενικός, ονομαστική
ρήση	ρήση	ουσιαστικό	θηλυκό, ενικός, κλητική
φρόντισε	φροντίζω	ρήμα	ενεργητική, αόριστος, οριστική, ενικός, 3ο πρόσωπο
δίνη	δίνη	ουσιαστικό	θηλυκό, ενικός, κλητική
μιλάμε	μιλώ	ρήμα	ενεργητική, ενεστώτας, οριστική, πληθυντικός, 1ο πρόσωπο
γεμάτα	γεμάτος	επίθετο	ουδέτερο, πληθυντικός, αιτιατική
συμπαθητική	συμπαθητικός	επίθετο	θηλυκό, ενικός, ονομαστική
συμπεριφορά	συμπεριφορά	ουσιαστικό	θηλυκό, ενικός, κλητική
κατηφορίζουν	κατηφορίζω	ρήμα	ενεργητική, ενεστώτας, οριστική, πληθυντικός, 3ο πρόσωπο
τύπο	τύπος	ουσιαστικό	αρσενικό, ενικός, αιτιατική
κουτσαίνοντας	κουτσαίνω	ρήμα	ενεργητική, ενεστώτας, μετοχή, , 
συμπαθούσε	συμπαθώ	ρήμα	ενεργητική, παρατατικός, οριστική, ενικός, 3ο πρόσωπο
σκοτώσατε	σκοτώνω	ρήμα	ενεργητική, αόριστος, οριστική, πληθυντικός, 2ο πρόσωπο
κυριαρχούσε	κυριαρχώ	ρήμα	ενεργητική, παρατατικός, οριστική, ενικός, 3ο πρόσωπο
γεμάτο	γεμάτος	επίθετο	αρσενικό, ενικός, αιτιατική
γεμάτη	γεμάτος	επίθετο	θηλυκό, ενικός, ονομαστική
μέλημα	μέλημα	ουσιαστικό	ουδέτερο, ενικός, κλητική
βασιλικής	βασιλικός	επίθετο	θηλυκό, ενικός, γενική
συνομήλικης	συνομήλικος	επίθετο	θηλυκό, ενικός, γενική
πανύψηλου	πανύψηλος	επίθετο	ουδέτερο, ενικός, γενική
σήμερα	σήμερα	επίρρημα	
προηγούμενο	προηγούμενος	επίθετο	αρσενικό, ενικός, αιτιατική
μαλώνετε	μαλώνω	ρήμα	ενεργητική, ενεστώτας, προστακτική, πληθυντικός, 2ο πρόσωπο
βασανίζει	βασανίζω	ρήμα	ενεργητική, ενεστώτας, οριστική, ενικός, 3ο πρόσωπο
φοβερή	φοβερός	επίθετο	θηλυκό, ενικός, ονομαστική
πύλη	πύλη	ουσιαστικό	θηλυκό, ενικός, κλητική
καλύβα	καλύβα	ουσιαστικό	θηλυκό, ενικός, κλητική
πολέμου	πόλεμος	ουσιαστικό	αρσενικό, ενικός, γενική
ιδιαίτερα	ιδιαίτερος	επίθετο	ουδέτερο, πληθυντικός, αιτιατική
φαίνεται	φαίνομαι	 ρήμα	 παθητική, ενεστώτας, οριστική, ενικός, 3ο πρόσωπο
ιδιαίτερη	ιδιαίτερος	επίθετο	θηλυκό, ενικός, ονομαστική
ιδιαίτερο	ιδιαίτερος	επίθετο	αρσενικό, ενικός, αιτιατική
συζήτηση	συζήτηση	ουσιαστικό	θηλυκό, ενικός, κλητική
ζούσανε	ζω	ρήμα	ενεργητική, παρατατικός, οριστική, πληθυντικός, 3ο πρόσωπο
ανώφελα	ανώφελος	επίθετο	ουδέτερο, πληθυντικός, αιτιατική
θυγατέρων	θυγατέρα	ουσιαστικό	θηλυκό, πληθυντικός, γενική
μίλια	μίλι	ουσιαστικό	ουδέτερο, πληθυντικός, αιτιατική
φορά	φορώ	ρήμα	ενεργητική, ενεστώτας, οριστική, ενικός, 3ο πρόσωπο
κοιμηθήκανε	κοιμούμαι	ρήμα	παθητική, αόριστος, οριστική, πληθυντικός, 3ο πρόσωπο
βαδίζει	βαδίζω	ρήμα	ενεργητική, ενεστώτας, οριστική, ενικός, 3ο πρόσωπο
μορφώναμε	μορφώνω	ρήμα	ενεργητική, παρατατικός, οριστική, πληθυντικός, 1ο πρόσωπο
κοίταζα	κοιτάζω	ρήμα	ενεργητική, παρατατικός, οριστική, ενικός, 1ο πρόσωπο
κοίταζε	κοιτάζω	ρήμα	ενεργητική, παρατατικός, οριστική, ενικός, 3ο πρόσωπο
ευλογημένο	ευλογημένος	επίθετο	αρσενικό, ενικός, αιτιατική
συμπάθησα	συμπαθώ	ρήμα	ενεργητική, αόριστος, οριστική, ενικός, 1ο πρόσωπο
μήτε	μήτε	σύνδεσμος	
ρακέτες	ρακέτα	ουσιαστικό	θηλυκό, πληθυντικός, αιτιατική
πολυμελή	πολυμελής	επίθετο	θηλυκό, ενικός, αιτιατική
συνεχίσει	συνεχίζω	ρήμα	ενεργητική, αόριστος, υποτακτική, ενικός, 3ο πρόσωπο
πιθανές	πιθανός	επίθετο	θηλυκό, πληθυντικός, ονομαστική
μπόλικο	μπόλικος	επίθετο	αρσενικό, ενικός, αιτιατική
τυχερή	τυχερός	επίθετο	θηλυκό, ενικός, ονομαστική
ζάχαρη	ζάχαρη	ουσιαστικό	θηλυκό, ενικός, κλητική
δέσει	δένω	ρήμα	ενεργητική, αόριστος, υποτακτική, ενικός, 3ο πρόσωπο
κεφάλι	κεφάλι	ουσιαστικό	ουδέτερο, ενικός, κλητική
ποτήρι	ποτήρι	ουσιαστικό	ουδέτερο, ενικός, κλητική
συνεταίροι	συνέταιρος	ουσιαστικό	αρσενικό, πληθυντικός, κλητική
θεραπεύτηκαν	θεραπεύω	ρήμα	παθητική, αόριστος, οριστική, πληθυντικός, 3ο πρόσωπο
παρατηρητή	παρατηρητής	ουσιαστικό	αρσενικό, ενικός, κλητική
μισά	μισός	επίθετο	ουδέτερο, πληθυντικός, αιτιατική
νόμισε	νομίζω	ρήμα	ενεργητική, αόριστος, οριστική, ενικός, 3ο πρόσωπο
νόμισα	νομίζω	ρήμα	ενεργητική, αόριστος, οριστική, ενικός, 1ο πρόσωπο
μισή	μισός	επίθετο	θηλυκό, ενικός, ονομαστική
τέλη	τέλος	ουσιαστικό	ουδέτερο, πληθυντικός, αιτιατική
χαρίσουν	χαρίζω	ρήμα	ενεργητική, αόριστος, υποτακτική, πληθυντικός, 3ο πρόσωπο
παμπόνηρη	παμπόνηρος	επίθετο	θηλυκό, ενικός, ονομαστική
παμπόνηρο	παμπόνηρος	επίθετο	αρσενικό, ενικός, αιτιατική
σημάδια	σημάδι	ουσιαστικό	ουδέτερο, πληθυντικός, αιτιατική
παχύ	παχύς	επίθετο	αρσενικό, ενικός, γενική
τσίγκο	τσίγκος	ουσιαστικό	αρσενικό, ενικός, αιτιατική
φορτώνεται	φορτώνω	ρήμα	παθητική, ενεστώτας, οριστική, ενικός, 3ο πρόσωπο
πνευματική	πνευματικός	επίθετο	θηλυκό, ενικός, ονομαστική
μοναδικός	μοναδικός	επίθετο	αρσενικό, ενικός, ονομαστική
διατήρηση	διατήρηση	ουσιαστικό	θηλυκό, ενικός, κλητική
ξύλινα	ξύλινος	επίθετο	ουδέτερο, πληθυντικός, αιτιατική
κινήθηκε	κινώ	ρήμα	παθητική, αόριστος, οριστική, ενικός, 3ο πρόσωπο
λοξοδρόμησε	λοξοδρομώ	ρήμα	ενεργητική, αόριστος, οριστική, ενικός, 3ο πρόσωπο
μητέρα	μητέρα	ουσιαστικό	θηλυκό, ενικός, κλητική
τενεκέ	τενεκές	ουσιαστικό	αρσενικό, ενικός, κλητική
αξιολύπητη	αξιολύπητος	επίθετο	θηλυκό, ενικός, ονομαστική
ξανά	ξανά	επίρρημα	
πεθυμούσαν	πεθυμώ	ρήμα	ενεργητική, παρατατικός, οριστική, πληθυντικός, 3ο πρόσωπο
θυγατέρα	θυγατέρα	ουσιαστικό	θηλυκό, ενικός, κλητική
όρμησε	ορμώ	ρήμα	ενεργητική, αόριστος, οριστική, ενικός, 3ο πρόσωπο
μαχαίρι	μαχαίρι	ουσιαστικό	ουδέτερο, ενικός, κλητική
κοιλάδα	κοιλάδα	ουσιαστικό	θηλυκό, ενικός, κλητική
θυμάσαι	θυμούμαι	ρήμα	παθητική, ενεστώτας, οριστική, ενικός, 2ο πρόσωπο
μηχανή	μηχανή	ουσιαστικό	θηλυκό, ενικός, κλητική
βυζαντινή	βυζαντινός	επίθετο	θηλυκό, ενικός, ονομαστική
φουκαράδες	φουκαράς	ουσιαστικό	αρσενικό, πληθυντικός, αιτιατική
παράτησε	παρατώ	ρήμα	ενεργητική, αόριστος, οριστική, ενικός, 3ο πρόσωπο
δείξει	δείχνω	ρήμα	ενεργητική, αόριστος, υποτακτική, ενικός, 3ο πρόσωπο
λιμάνι	λιμάνι	ουσιαστικό	ουδέτερο, ενικός, κλητική
πολυθρόνες	πολυθρόνα	ουσιαστικό	θηλυκό, πληθυντικός, αιτιατική
βότσαλα	βότσαλο	ουσιαστικό	ουδέτερο, πληθυντικός, αιτιατική
μερίδα	μερίδα	ουσιαστικό	θηλυκό, ενικός, κλητική
χαριτωμένο	χαριτωμένος	επίθετο	αρσενικό, ενικός, αιτιατική
νόμιζα	νομίζω	ρήμα	ενεργητική, παρατατικός, οριστική, ενικός, 1ο πρόσωπο
φωνητικούς	φωνητικός	επίθετο	αρσενικό, πληθυντικός, αιτιατική
νόμιζε	νομίζω	ρήμα	ενεργητική, παρατατικός, οριστική, ενικός, 3ο πρόσωπο
ονόματα	όνομα	ουσιαστικό	ουδέτερο, πληθυντικός, αιτιατική
διαλέγοντας	διαλέγω	ρήμα	ενεργητική, ενεστώτας, μετοχή, , 
λείψει	λείπω	ρήμα	ενεργητική, αόριστος, υποτακτική, ενικός, 3ο πρόσωπο
συζητήσεις	συζήτηση	ουσιαστικό	θηλυκό, πληθυντικός, αιτιατική
γυναίκα	γυναίκα	ουσιαστικό	θηλυκό, ενικός, κλητική
μαλώνουμε	μαλώνω	ρήμα	ενεργητική, ενεστώτας, οριστική, πληθυντικός, 1ο πρόσωπο
δισεκατομμυριούχος	δισεκατομμυριούχος	ουσιαστικό	θηλυκό, ενικός, ονομαστική
κορίτσια	κορίτσι	ουσιαστικό	ουδέτερο, πληθυντικός, αιτιατική
παραμόνευε	παραμονεύω	ρήμα	ενεργητική, παρατατικός, οριστική, ενικός, 3ο πρόσωπο
πελάγου	πέλαγο	ουσιαστικό	ουδέτερο, ενικός, γενική
ελαττώματα	ελάττωμα	ουσιαστικό	ουδέτερο, πληθυντικός, αιτιατική
χαλί	χαλί	ουσιαστικό	ουδέτερο, ενικός, κλητική
ελαττώματα	ελάττωμα	ουσιαστικό	ουδέτερο, πληθυντικός, αιτιατική
ξύλα	ξύλο	ουσιαστικό	ουδέτερο, πληθυντικός, αιτιατική
θερίσουμε	θερίζω	ρήμα	ενεργητική, αόριστος, υποτακτική, πληθυντικός, 1ο πρόσωπο
συνάντησης	συνάντηση	ουσιαστικό	θηλυκό, ενικός, γενική
μπορούσα	μπορώ	ρήμα	ενεργητική, παρατατικός, οριστική, ενικός, 1ο πρόσωπο
ξένου	ξένος	επίθετο	ουδέτερο, ενικός, γενική
μπορούσε	μπορώ	ρήμα	ενεργητική, παρατατικός, οριστική, ενικός, 3ο πρόσωπο
παρεξηγούν	παρεξηγώ	ρήμα	ενεργητική, ενεστώτας, οριστική, πληθυντικός, 3ο πρόσωπο
καλύτερα	καλύτερος	επίθετο	ουδέτερο, πληθυντικός, αιτιατική
πεινάσετε	πεινώ	ρήμα	ενεργητική, αόριστος, υποτακτική, πληθυντικός, 2ο πρόσωπο
κατωτερότητα	κατωτερότητα	ουσιαστικό	θηλυκό, ενικός, κλητική
ξεκουράζει	ξεκουράζω	ρήμα	ενεργητική, ενεστώτας, οριστική, ενικός, 3ο πρόσωπο
ξακουστός	ξακουστός	επίθετο	αρσενικό, ενικός, ονομαστική
πουλιούνται	πουλάω	ρήμα	παθητική, ενεστώτας, οριστική, πληθυντικός, 3ο πρόσωπο
κατοχή	κατοχή	ουσιαστικό	θηλυκό, ενικός, κλητική
ρόπαλα	ρόπαλο	ουσιαστικό	ουδέτερο, πληθυντικός, αιτιατική
γήπεδο	γήπεδο	ουσιαστικό	ουδέτερο, ενικός, κλητική
συνείδηση	συνείδηση	ουσιαστικό	θηλυκό, ενικός, κλητική
κουκουβάγιας	κουκουβάγια	ουσιαστικό	θηλυκό, ενικός, γενική
βαρυσήμαντο	βαρυσήμαντος	επίθετο	αρσενικό, ενικός, αιτιατική
χαρά	χαρά	ουσιαστικό	θηλυκό, ενικός, κλητική
παντρεύτηκε	παντρεύω	ρήμα	παθητική, αόριστος, οριστική, ενικός, 3ο πρόσωπο
δοκίμιο	δοκίμιο	ουσιαστικό	ουδέτερο, ενικός, κλητική
πάτησες	πατώ	ρήμα	ενεργητική, αόριστος, οριστική, ενικός, 2ο πρόσωπο
φάλαινες	φάλαινα	ουσιαστικό	θηλυκό, πληθυντικός, αιτιατική
μόνιμο	μόνιμος	επίθετο	αρσενικό, ενικός, αιτιατική
ρούχα	ρούχο	ουσιαστικό	ουδέτερο, πληθυντικός, αιτιατική
λιμπιζόταν	λιμπίζομαι	ρήμα	παθητική, παρατατικός, οριστική, ενικός, 3ο πρόσωπο
λοιποί	λοιπός	επίθετο	αρσενικό, πληθυντικός, κλητική
καταβρόχθιζε	καταβροχθίζω	ρήμα	ενεργητική, παρατατικός, οριστική, ενικός, 3ο πρόσωπο
χαρίζω	χαρίζω	ρήμα	ενεργητική, ενεστώτας, οριστική, ενικός, 1ο πρόσωπο
φιλικά	φιλικός	επίθετο	ουδέτερο, πληθυντικός, αιτιατική
καθαρός	καθαρός	επίθετο	αρσενικό, ενικός, ονομαστική
παλαιότητα	παλαιότητα	ουσιαστικό	θηλυκό, ενικός, κλητική
καραβοκύρης	καραβοκύρης	ουσιαστικό	αρσενικό, ενικός, ονομαστική
μητέρας	μητέρα	ουσιαστικό	θηλυκό, ενικός, γενική
γελάνε	γελώ	ρήμα	ενεργητική, ενεστώτας, οριστική, πληθυντικός, 3ο πρόσωπο
βάραινε	βαραίνω	ρήμα	ενεργητική, παρατατικός, οριστική, ενικός, 3ο πρόσωπο
πολυμήχανο	πολυμήχανος	επίθετο	αρσενικό, ενικός, αιτιατική
φορούσε	φορώ	ρήμα	ενεργητική, παρατατικός, οριστική, ενικός, 3ο πρόσωπο
γεμίζει	γεμίζω	ρήμα	ενεργητική, ενεστώτας, οριστική, ενικός, 3ο πρόσωπο
χώθηκε	χώνω	ρήμα	παθητική, αόριστος, οριστική, ενικός, 3ο πρόσωπο
καραβοκύρη	καραβοκύρης	ουσιαστικό	αρσενικό, ενικός, κλητική
κοινού	κοινός	επίθετο	ουδέτερο, ενικός, γενική
ανώμαλο	ανώμαλος	επίθετο	αρσενικό, ενικός, αιτιατική
φάλαινας	φάλαινα	ουσιαστικό	θηλυκό, ενικός, γενική
μιμήθηκε	μιμούμαι	ρήμα	παθητική, αόριστος, οριστική, ενικός, 3ο πρόσωπο
πιτζάμες	πιτζάμα	ουσιαστικό	θηλυκό, πληθυντικός, αιτιατική
μετωπικά	μετωπικός	επίθετο	ουδέτερο, πληθυντικός, αιτιατική
νερού	νερό	ουσιαστικό	ουδέτερο, ενικός, γενική
ζυμώσουμε	ζυμώνω	ρήμα	ενεργητική, αόριστος, υποτακτική, πληθυντικός, 1ο πρόσωπο
λουλουδιών	λουλούδι	ουσιαστικό	ουδέτερο, πληθυντικός, γενική
προσποιήθηκε	προσποιούμαι	ρήμα	παθητική, αόριστος, οριστική, ενικός, 3ο πρόσωπο
ανθόγαλα	ανθόγαλο	ουσιαστικό	ουδέτερο, πληθυντικός, αιτιατική
συναντήσει	συναντώ	ρήμα	ενεργητική, αόριστος, υποτακτική, ενικός, 3ο πρόσωπο
πατέρας	πατέρας	ουσιαστικό	αρσενικό, ενικός, ονομαστική
ψωμί	ψωμί	ουσιαστικό	ουδέτερο, ενικός, κλητική
σουτάρει	σουτέρνω	ρήμα	ενεργητική, αόριστος, υποτακτική, ενικός, 3ο πρόσωπο
περιφερικού	περιφερικός	επίθετο	ουδέτερο, ενικός, γενική
νευρικά	νευρικός	επίθετο	ουδέτερο, πληθυντικός, αιτιατική
φύλαγε	φυλάγω	ρήμα	ενεργητική, παρατατικός, οριστική, ενικός, 3ο πρόσωπο
βιολετί	βιολετί	επίθετο	άκλιτο
γενικεύτηκε	γενικεύω	ρήμα	παθητική, αόριστος, οριστική, ενικός, 3ο πρόσωπο
παρακάτω	παρακάτω	επίρρημα	
σίγουρος	σίγουρος	επίθετο	αρσενικό, ενικός, ονομαστική
τυπικούς	τυπικός	επίθετο	αρσενικό, πληθυντικός, αιτιατική
καναπέ	καναπές	ουσιαστικό	αρσενικό, ενικός, κλητική
κάτι	κάτι	 αντωνυμία	 άκλιτο, αόριστη
μεγαλώσει	μεγαλώνω	ρήμα	ενεργητική, αόριστος, υποτακτική, ενικός, 3ο πρόσωπο
κάτω	κάτω	επίρρημα	
παίξω	παίζω	ρήμα	ενεργητική, αόριστος, υποτακτική, ενικός, 1ο πρόσωπο
παίξε	παίζω	ρήμα	ενεργητική, αόριστος, προστακτική, ενικός, 2ο πρόσωπο
πάτησε	πατώ	ρήμα	ενεργητική, αόριστος, οριστική, ενικός, 3ο πρόσωπο
σοβαρά	σοβαρός	επίθετο	ουδέτερο, πληθυντικός, αιτιατική
λόξιγκα	λόξιγκας	ουσιαστικό	αρσενικό, ενικός, κλητική
αγόρασε	αγοράζω	ρήμα	ενεργητική, αόριστος, οριστική, ενικός, 3ο πρόσωπο
λόξιγκα	λόξιγκας	ουσιαστικό	αρσενικό, ενικός, κλητική
χάραζαν	χαράζω	ρήμα	ενεργητική, παρατατικός, οριστική, πληθυντικός, 3ο πρόσωπο
γαλάζια	γαλάζιος	επίθετο	θηλυκό, ενικός, ονομαστική
κατόρθωμα	κατόρθωμα	ουσιαστικό	ουδέτερο, ενικός, κλητική
χήρα	χήρα	ουσιαστικό	θηλυκό, ενικός, κλητική
δεκάρικο	δεκάρικο	ουσιαστικό	ουδέτερο, ενικός, κλητική
φύση	φύση	ουσιαστικό	θηλυκό, ενικός, κλητική
γαλάζιο	γαλάζιος	επίθετο	αρσενικό, ενικός, αιτιατική
σκότωσε	σκοτώνω	ρήμα	ενεργητική, αόριστος, οριστική, ενικός, 3ο πρόσωπο
τζάκι	τζάκι	ουσιαστικό	ουδέτερο, ενικός, κλητική
θέμα	θέμα	ουσιαστικό	ουδέτερο, ενικός, κλητική
διηγηματικών	διηγηματικός	επίθετο	θηλυκό, πληθυντικός, γενική
ξεροί	ξερός	επίθετο	αρσενικό, πληθυντικός, κλητική
θέλω	θέλω	 ρήμα	 ενεργητική, ενεστώτας, οριστική, ενικός, 1ο πρόσωπο
κατευθύνεται	κατευθύνω	ρήμα	παθητική, ενεστώτας, οριστική, ενικός, 3ο πρόσωπο
μιλήσω	μιλώ	ρήμα	ενεργητική, αόριστος, υποτακτική, ενικός, 1ο πρόσωπο
κάνω	κάνω	 ρήμα	 ενεργητική, ενεστώτας, οριστική, ενικός, πρώτο
εύκολο	εύκολος	επίθετο	αρσενικό, ενικός, αιτιατική
ψιθύρισε	ψιθυρίζω	ρήμα	ενεργητική, αόριστος, οριστική, ενικός, 3ο πρόσωπο
όρεξη	όρεξη	ουσιαστικό	θηλυκό, ενικός, κλητική
κυρά	κυρά	ουσιαστικό	θηλυκό, ενικός, κλητική
εύκολα	εύκολος	επίθετο	ουδέτερο, πληθυντικός, αιτιατική
πρόσωπα	πρόσωπο	ουσιαστικό	ουδέτερο, πληθυντικός, αιτιατική
σοβαρό	σοβαρός	επίθετο	αρσενικό, ενικός, αιτιατική
πεινούσε	πεινώ	ρήμα	ενεργητική, παρατατικός, οριστική, ενικός, 3ο πρόσωπο
πρόσωπο	πρόσωπο	ουσιαστικό	ουδέτερο, ενικός, κλητική
πρόσωπο	πρόσωπο	ουσιαστικό	ουδέτερο, ενικός, κλητική
φωνάζουν	φωνάζω	ρήμα	ενεργητική, ενεστώτας, οριστική, πληθυντικός, 3ο πρόσωπο
εθνικότητα	εθνικότητα	ουσιαστικό	θηλυκό, ενικός, κλητική
ξεχώρισε	ξεχωρίζω	ρήμα	ενεργητική, αόριστος, οριστική, ενικός, 3ο πρόσωπο
καθαρίστρια	καθαρίστρια	ουσιαστικό	θηλυκό, ενικός, κλητική
θανάσιμο	θανάσιμος	επίθετο	αρσενικό, ενικός, αιτιατική
θέση	θέση	ουσιαστικό	θηλυκό, ενικός, κλητική
πολιτισμό	πολιτισμός	ουσιαστικό	αρσενικό, ενικός, αιτιατική
θέριζε	θερίζω	ρήμα	ενεργητική, παρατατικός, οριστική, ενικός, 3ο πρόσωπο
ξεγύμνωμα	ξεγύμνωμα	ουσιαστικό	ουδέτερο, ενικός, κλητική
καλούσαν	καλώ	ρήμα	ενεργητική, παρατατικός, οριστική, πληθυντικός, 3ο πρόσωπο
κοπέλα	κοπέλα	ουσιαστικό	θηλυκό, ενικός, κλητική
παραπάνω	παραπάνω	επίρρημα	
τυλίξεις	τυλίγω	ρήμα	ενεργητική, αόριστος, υποτακτική, ενικός, 2ο πρόσωπο
συνέχεια	συνέχεια	ουσιαστικό	θηλυκό, ενικός, κλητική
ζούμε	ζω	ρήμα	ενεργητική, ενεστώτας, οριστική, πληθυντικός, 1ο πρόσωπο
εδραιώθηκε	εδραιώνω	ρήμα	παθητική, αόριστος, οριστική, ενικός, 3ο πρόσωπο
κατάλοιπο	κατάλοιπο	ουσιαστικό	ουδέτερο, ενικός, κλητική
κάθε	κάθε	 αντωνυμία	 άκλιτο, αόριστη
καθημερινή	καθημερινός	επίθετο	θηλυκό, ενικός, ονομαστική
καλοκαιρινά	καλοκαιρινός	επίθετο	ουδέτερο, πληθυντικός, αιτιατική
κομψότητα	κομψότητα	ουσιαστικό	θηλυκό, ενικός, κλητική
φανατικά	φανατικός	επίθετο	ουδέτερο, πληθυντικός, αιτιατική
σήκωσε	σηκώνω	ρήμα	ενεργητική, αόριστος, οριστική, ενικός, 3ο πρόσωπο
διαβάσετε	διαβάζω	ρήμα	ενεργητική, αόριστος, υποτακτική, πληθυντικός, 2ο πρόσωπο
πέλαγο	πέλαγο	ουσιαστικό	ουδέτερο, ενικός, κλητική
λίγα	λίγος	επίθετο	ουδέτερο, πληθυντικός, αιτιατική
ψηλαφίσει	ψηλαφίζω	ρήμα	ενεργητική, αόριστος, υποτακτική, ενικός, 3ο πρόσωπο
πολυθρόνα	πολυθρόνα	ουσιαστικό	θηλυκό, ενικός, κλητική
ψωμάδες	ψωμάς	ουσιαστικό	αρσενικό, πληθυντικός, αιτιατική
καλοκαιριού	καλοκαίρι	ουσιαστικό	ουδέτερο, ενικός, γενική
κοιμηθούνε	κοιμούμαι	ρήμα	παθητική, αόριστος, υποτακτική, πληθυντικός, 3ο πρόσωπο
γεμίζω	γεμίζω	ρήμα	ενεργητική, ενεστώτας, οριστική, ενικός, 1ο πρόσωπο
πεταλούδα	πεταλούδα	ουσιαστικό	θηλυκό, ενικός, κλητική
κοπάνιζε	κοπανίζω	ρήμα	ενεργητική, παρατατικός, οριστική, ενικός, 3ο πρόσωπο
κίνηση	κίνηση	ουσιαστικό	θηλυκό, ενικός, κλητική
φαντάζεται	φαντάζομαι	ρήμα	παθητική, ενεστώτας, οριστική, ενικός, 3ο πρόσωπο
συνέχισαν	συνεχίζω	ρήμα	ενεργητική, αόριστος, οριστική, πληθυντικός, 3ο πρόσωπο
κάματο	κάματος	ουσιαστικό	αρσενικό, ενικός, αιτιατική
λίγο	λίγος	επίθετο	αρσενικό, ενικός, αιτιατική
ποντίκι	ποντίκι	ουσιαστικό	ουδέτερο, ενικός, κλητική
ζούσε	ζω	ρήμα	ενεργητική, παρατατικός, οριστική, ενικός, 3ο πρόσωπο
χώνεται	χώνω	ρήμα	παθητική, ενεστώτας, οριστική, ενικός, 3ο πρόσωπο
ελεύθερο	ελεύθερος	επίθετο	αρσενικό, ενικός, αιτιατική
ψηφιδωτό	ψηφιδωτός	επίθετο	αρσενικό, ενικός, αιτιατική
παράταιρη	παράταιρος	επίθετο	θηλυκό, ενικός, ονομαστική
παλατιού	παλάτι	ουσιαστικό	ουδέτερο, ενικός, γενική
ράσα	ράσο	ουσιαστικό	ουδέτερο, πληθυντικός, αιτιατική
μονόξυλα	μονόξυλο	ουσιαστικό	ουδέτερο, πληθυντικός, αιτιατική
γάλα	γάλα	ουσιαστικό	ουδέτερο, ενικός, κλητική
κοίτα	κοιτώ	ρήμα	ενεργητική, ενεστώτας, προστακτική, ενικός, 2ο πρόσωπο
ξημερώνοντας	ξημερώνω	ρήμα	ενεργητική, ενεστώτας, μετοχή, , 
μακάρια	μακαρίζω	ρήμα	ενεργητική, παρατατικός, οριστική, ενικός, 1ο πρόσωπο
βασιλική	βασιλικός	επίθετο	θηλυκό, ενικός, ονομαστική
καταγωγή	καταγωγή	ουσιαστικό	θηλυκό, ενικός, κλητική
δύναμη	δύναμη	ουσιαστικό	θηλυκό, ενικός, κλητική
δύναμη	δύναμη	ουσιαστικό	θηλυκό, ενικός, κλητική
γυρίσανε	γυρίζω	ρήμα	ενεργητική, αόριστος, οριστική, πληθυντικός, 3ο πρόσωπο
γάτα	γάτα	ουσιαστικό	θηλυκό, ενικός, κλητική
μιλούσαμε	μιλώ	ρήμα	ενεργητική, παρατατικός, οριστική, πληθυντικός, 1ο πρόσωπο
πίπιζα	πίπιζα	ουσιαστικό	θηλυκό, ενικός, κλητική
πρόθυμα	πρόθυμος	επίθετο	ουδέτερο, πληθυντικός, αιτιατική
ρεζίλι	ρεζίλι	ουσιαστικό	, ενικός, κλητική
πονέσω	πονάω	ρήμα	ενεργητική, αόριστος, υποτακτική, ενικός, 1ο πρόσωπο
παράθυρο	παράθυρο	ουσιαστικό	ουδέτερο, ενικός, κλητική
φιγούρες	φιγούρα	ουσιαστικό	θηλυκό, πληθυντικός, αιτιατική
μηρυκάσετε	μηρυκάζω	ρήμα	ενεργητική, αόριστος, υποτακτική, πληθυντικός, 2ο πρόσωπο
πανύψηλα	πανύψηλος	επίθετο	ουδέτερο, πληθυντικός, αιτιατική
όνειρο	όνειρο	ουσιαστικό	ουδέτερο, ενικός, κλητική
τοιχώματα	τοίχωμα	ουσιαστικό	ουδέτερο, πληθυντικός, αιτιατική
πουλί	πουλί	ουσιαστικό	ουδέτερο, ενικός, κλητική
αγέρινα	αγέρινος	επίθετο	ουδέτερο, πληθυντικός, αιτιατική
ριζικά	ριζικός	επίθετο	ουδέτερο, πληθυντικός, αιτιατική
υπόθεση	υπόθεση	ουσιαστικό	θηλυκό, ενικός, κλητική
παιδί	παιδί	ουσιαστικό	ουδέτερο, ενικός, κλητική
πέρασε	περνώ	 ρήμα	 ενεργητική, αόριστος, οριστική, ενικός, 3ο πρόσωπο
θάνατο	θάνατος	ουσιαστικό	αρσενικό, ενικός, αιτιατική
δεύτερη	δεύτερος	επίθετο	θηλυκό, ενικός, ονομαστική
δεύτερο	δεύτερος	επίθετο	αρσενικό, ενικός, αιτιατική
πάρα	πάρα	επίρρημα	
λιβάδια	λιβάδι	ουσιαστικό	ουδέτερο, πληθυντικός, αιτιατική
τέντωσε	τεντώνω	ρήμα	ενεργητική, αόριστος, οριστική, ενικός, 3ο πρόσωπο
μεγαλειώδης	μεγαλειώδης	επίθετο	θηλυκό, ενικός, ονομαστική
πάνω	επάνω	 επίρρημα	 τοπικό
χαζέψω	χαζεύω	ρήμα	ενεργητική, αόριστος, υποτακτική, ενικός, 1ο πρόσωπο
κέφαλο	κέφαλος	ουσιαστικό	αρσενικό, ενικός, αιτιατική
παραμυθιών	παραμύθι	ουσιαστικό	ουδέτερο, πληθυντικός, γενική
μαζί	μαζί	επίρρημα	
λυπημένη	λυπημένος	επίθετο	θηλυκό, ενικός, ονομαστική
καλύτερα	καλύτερος	επίθετο	ουδέτερο, πληθυντικός, αιτιατική
πάλε	πάλε	επίρρημα	
νομίζει	νομίζω	ρήμα	ενεργητική, ενεστώτας, οριστική, ενικός, 3ο πρόσωπο
πάλι	πάλι	επίρρημα	
δοκιμάσεις	δοκιμάζω	ρήμα	ενεργητική, αόριστος, υποτακτική, ενικός, 2ο πρόσωπο
μανίκι	μανίκι	ουσιαστικό	ουδέτερο, ενικός, κλητική
ρέμα	ρέμα	ουσιαστικό	ουδέτερο, ενικός, κλητική
βέλο	βέλο	ουσιαστικό	ουδέτερο, ενικός, κλητική
γυρέψω	γυρεύω	ρήμα	ενεργητική, αόριστος, υποτακτική, ενικός, 1ο πρόσωπο
πέταξε	πετώ	ρήμα	ενεργητική, αόριστος, οριστική, ενικός, 3ο πρόσωπο
σάλεψε	σαλεύω	ρήμα	ενεργητική, αόριστος, οριστική, ενικός, 3ο πρόσωπο
κολύμπι	κολύμπι	ουσιαστικό	, ενικός, κλητική
γυρίζει	γυρίζω	ρήμα	ενεργητική, ενεστώτας, οριστική, ενικός, 3ο πρόσωπο
γαντζώνομαι	γαντζώνω	ρήμα	παθητική, ενεστώτας, οριστική, ενικός, 1ο πρόσωπο
δεμάτια	δεμάτι	ουσιαστικό	ουδέτερο, πληθυντικός, αιτιατική
φοβηθήκατε	φοβούμαι	ρήμα	παθητική, αόριστος, οριστική, πληθυντικός, 2ο πρόσωπο
βωμολοχιών	βωμολοχία	ουσιαστικό	θηλυκό, πληθυντικός, γενική
δίνη	δίνη	ουσιαστικό	θηλυκό, ενικός, κλητική
χωματένιο	χωματένιος	επίθετο	αρσενικό, ενικός, αιτιατική
δύση	δύση	ουσιαστικό	θηλυκό, ενικός, κλητική
ξεφωνίζει	ξεφωνίζω	ρήμα	ενεργητική, ενεστώτας, οριστική, ενικός, 3ο πρόσωπο
πάντα	πάντα	ουσιαστικό	άκλιτο
φιλοσόφου	φιλόσοφος	ουσιαστικό	αρσενικό, ενικός, γενική
πληγώνομαι	πληγώνω	ρήμα	παθητική, ενεστώτας, οριστική, ενικός, 1ο πρόσωπο
μαμά	μαμά	ουσιαστικό	θηλυκό, ενικός, κλητική
σούρουπο	σούρουπο	ουσιαστικό	ουδέτερο, ενικός, κλητική
πάσα	πάσο	ουσιαστικό	ουδέτερο, πληθυντικός, αιτιατική
βουνού	βουνό	ουσιαστικό	ουδέτερο, ενικός, γενική
φτιαγμένη	φτιάχνω	μετοχή	 παθητική, παρακείμενος, θηλυκό, ενικός, ονομαστική, αιτιατική, κλητική
μαγευτική	μαγευτικός	επίθετο	θηλυκό, ενικός, ονομαστική
αξιαγάπητος	αξιαγάπητος	επίθετο	αρσενικό, ενικός, ονομαστική
φώτιση	φώτιση	ουσιαστικό	θηλυκό, ενικός, κλητική
μουσούδα	μουσούδα	ουσιαστικό	θηλυκό, ενικός, κλητική
νίκη	νίκη	ουσιαστικό	θηλυκό, ενικός, κλητική
τελικά	τελικός	επίθετο	ουδέτερο, πληθυντικός, αιτιατική
ξέρει	ξέρω	 ρήμα	 ενεργητική, ενεστώτας, οριστική, ενικός, 3ο πρόσωπο
απότομα	απότομος	επίθετο	ουδέτερο, πληθυντικός, αιτιατική
υπόλοιπη	υπόλοιπος	επίθετο	θηλυκό, ενικός, ονομαστική
διαιτητή	διαιτητής	ουσιαστικό	αρσενικό, ενικός, κλητική
διηγούνται	διηγούμαι	ρήμα	παθητική, ενεστώτας, οριστική, πληθυντικός, 3ο πρόσωπο
παράξενος	παράξενος	επίθετο	αρσενικό, ενικός, ονομαστική
γύρισε	γυρίζω	ρήμα	ενεργητική, αόριστος, οριστική, ενικός, 3ο πρόσωπο
φωτεινά	φωτεινός	επίθετο	ουδέτερο, πληθυντικός, αιτιατική
διαφορετικό	διαφορετικός	επίθετο	αρσενικό, ενικός, αιτιατική
δοκιμάσει	δοκιμάζω	ρήμα	ενεργητική, αόριστος, υποτακτική, ενικός, 3ο πρόσωπο
χάρη	χάρη	ουσιαστικό	θηλυκό, ενικός, κλητική
φώναξε	φωνάζω	ρήμα	ενεργητική, αόριστος, οριστική, ενικός, 3ο πρόσωπο
πόνεσε	πονάω	ρήμα	ενεργητική, αόριστος, οριστική, ενικός, 3ο πρόσωπο
παράξενο	παράξενος	επίθετο	αρσενικό, ενικός, αιτιατική
παράξενη	παράξενος	επίθετο	θηλυκό, ενικός, ονομαστική
πάτωμα	πάτωμα	ουσιαστικό	ουδέτερο, ενικός, κλητική
μουγκάνισε	μουγκανίζω	ρήμα	ενεργητική, αόριστος, οριστική, ενικός, 3ο πρόσωπο
καλοκαίρι	καλοκαίρι	ουσιαστικό	ουδέτερο, ενικός, κλητική
δοκίμασα	δοκιμάζω	ρήμα	ενεργητική, αόριστος, οριστική, ενικός, 1ο πρόσωπο
νησί	νησί	ουσιαστικό	ουδέτερο, ενικός, κλητική
ξαναγύριζε	ξαναγυρίζω	ρήμα	ενεργητική, παρατατικός, οριστική, ενικός, 3ο πρόσωπο
λέξη	λέξη	ουσιαστικό	θηλυκό, ενικός, κλητική
βουνά	βουνό	ουσιαστικό	ουδέτερο, πληθυντικός, αιτιατική
μονομάχησα	μονομαχώ	ρήμα	ενεργητική, αόριστος, οριστική, ενικός, 1ο πρόσωπο
τινάζεται	τινάζω	ρήμα	παθητική, ενεστώτας, οριστική, ενικός, 3ο πρόσωπο
ζύμωσαν	ζυμώνω	ρήμα	ενεργητική, αόριστος, οριστική, πληθυντικός, 3ο πρόσωπο
φυσούσε	φυσάω	ρήμα	ενεργητική, παρατατικός, οριστική, ενικός, 3ο πρόσωπο
χάλι	χάλι	ουσιαστικό	, ενικός, κλητική
φώναζε	φωνάζω	ρήμα	ενεργητική, παρατατικός, οριστική, ενικός, 3ο πρόσωπο
πάγκου	πάγκος	ουσιαστικό	αρσενικό, ενικός, γενική
βοηθούσε	βοηθώ	ρήμα	ενεργητική, παρατατικός, οριστική, ενικός, 3ο πρόσωπο
γέροντα	γέροντας	ουσιαστικό	αρσενικό, ενικός, κλητική
χειρότερα	χειρότερος	επίθετο	ουδέτερο, πληθυντικός, αιτιατική
μάγουλο	μάγουλο	ουσιαστικό	ουδέτερο, ενικός, κλητική
τεράστια	τεράστιος	επίθετο	θηλυκό, ενικός, ονομαστική
κοιτάζω	κοιτάζω	ρήμα	ενεργητική, ενεστώτας, οριστική, ενικός, 1ο πρόσωπο
βάδιζαν	βαδίζω	ρήμα	ενεργητική, παρατατικός, οριστική, πληθυντικός, 3ο πρόσωπο
χειρότερο	χειρότερος	επίθετο	αρσενικό, ενικός, αιτιατική
καλημέρα	καλημέρα	επιφώνημα	
μεσογειακό	μεσογειακός	επίθετο	αρσενικό, ενικός, αιτιατική
ξεφώνισε	ξεφωνίζω	ρήμα	ενεργητική, αόριστος, οριστική, ενικός, 3ο πρόσωπο
μεγάλες	μεγάλος	επίθετο	θηλυκό, πληθυντικός, ονομαστική
ποτέ	ποτέ	επίρρημα	
καθηγητής	καθηγητής	ουσιαστικό	αρσενικό, ενικός, ονομαστική
θυμάρι	θυμάρι	ουσιαστικό	ουδέτερο, ενικός, κλητική
πηγάζει	πηγάζω	ρήμα	ενεργητική, ενεστώτας, οριστική, ενικός, 3ο πρόσωπο
γιατρεύτηκε	γιατρεύω	ρήμα	παθητική, αόριστος, οριστική, ενικός, 3ο πρόσωπο
ξεπεταγόταν	ξεπετάγομαι	ρήμα	παθητική, παρατατικός, οριστική, ενικός, 3ο πρόσωπο
κατήφορος	κατήφορος	ουσιαστικό	αρσενικό, ενικός, ονομαστική
πέρα	πέρα	επίρρημα	
λουρίδες	λουρίδα	ουσιαστικό	θηλυκό, πληθυντικός, αιτιατική
μονάχα	μονάχα	επίρρημα	
καλοσυνάτα	καλοσυνάτος	επίθετο	ουδέτερο, πληθυντικός, αιτιατική
τεράστιο	τεράστιος	επίθετο	αρσενικό, ενικός, αιτιατική
ξένα	ξένος	επίθετο	ουδέτερο, πληθυντικός, αιτιατική
ξένε	ξένος	επίθετο	αρσενικό, ενικός, κλητική
φωνάζοντας	φωνάζω	ρήμα	ενεργητική, ενεστώτας, μετοχή, , 
ξεχειλίζει	ξεχειλίζω	ρήμα	ενεργητική, ενεστώτας, οριστική, ενικός, 3ο πρόσωπο
συναντήσετε	συναντώ	ρήμα	ενεργητική, αόριστος, υποτακτική, πληθυντικός, 2ο πρόσωπο
πολυλογούμε	πολυλογώ	ρήμα	ενεργητική, ενεστώτας, οριστική, πληθυντικός, 1ο πρόσωπο
κοιτάνε	κοιτώ	ρήμα	ενεργητική, ενεστώτας, οριστική, πληθυντικός, 3ο πρόσωπο
παράπονο	παράπονο	ουσιαστικό	ουδέτερο, ενικός, κλητική
πρωτόγονη	πρωτόγονος	επίθετο	θηλυκό, ενικός, ονομαστική
χαμογέλασε	χαμογελώ	ρήμα	ενεργητική, αόριστος, οριστική, ενικός, 3ο πρόσωπο
σοφή	σοφός	επίθετο	θηλυκό, ενικός, ονομαστική
κούτσουρο	κούτσουρο	ουσιαστικό	ουδέτερο, ενικός, κλητική
κούτσουρα	κούτσουρο	ουσιαστικό	ουδέτερο, πληθυντικός, αιτιατική
ξανάνιωμα	ξανάνιωμα	ουσιαστικό	ουδέτερο, ενικός, κλητική
μεγάλης	μεγάλος	επίθετο	θηλυκό, ενικός, γενική
καραβιών	καράβι	ουσιαστικό	ουδέτερο, πληθυντικός, γενική
συναγωνίζονται	συναγωνίζομαι	ρήμα	παθητική, ενεστώτας, οριστική, πληθυντικός, 3ο πρόσωπο
βασίλισσα	βασίλισσα	ουσιαστικό	θηλυκό, ενικός, κλητική
κουφάλα	κουφάλα	ουσιαστικό	θηλυκό, ενικός, κλητική
συγκινημένος	συγκινημένος	επίθετο	αρσενικό, ενικός, ονομαστική
παραχωρεί	παραχωρώ	ρήμα	ενεργητική, ενεστώτας, οριστική, ενικός, 3ο πρόσωπο
μεγάλο	μεγάλος	επίθετο	αρσενικό, ενικός, αιτιατική
μεγάλη	μεγάλος	επίθετο	θηλυκό, ενικός, ονομαστική
μοιράζει	μοιράζω	ρήμα	ενεργητική, ενεστώτας, οριστική, ενικός, 3ο πρόσωπο
μεγάλα	μεγάλος	επίθετο	ουδέτερο, πληθυντικός, αιτιατική
μεσημέρι	μεσημέρι	ουσιαστικό	ουδέτερο, ενικός, κλητική
μυρίζονταν	μυρίζω	ρήμα	παθητική, παρατατικός, οριστική, πληθυντικός, 3ο πρόσωπο
ψυχή	ψυχή	ουσιαστικό	θηλυκό, ενικός, κλητική
μπορεί	μπορώ	ρήμα	ενεργητική, ενεστώτας, οριστική, ενικός, 3ο πρόσωπο
χέρι	χέρι	ουσιαστικό	ουδέτερο, ενικός, κλητική
κολυμπήσεις	κολυμπώ	ρήμα	ενεργητική, αόριστος, υποτακτική, ενικός, 2ο πρόσωπο
χασάπη	χασάπης	ουσιαστικό	αρσενικό, ενικός, κλητική
βασίλειο	βασίλειο	ουσιαστικό	ουδέτερο, ενικός, κλητική
καινούριες	καινούριος	επίθετο	θηλυκό, πληθυντικός, ονομαστική
παράπλευρα	παράπλευρος	επίθετο	ουδέτερο, πληθυντικός, αιτιατική
παραπατώντας	παραπατώ	ρήμα	ενεργητική, ενεστώτας, μετοχή, , 
κοντά	κοντός	επίθετο	ουδέτερο, πληθυντικός, αιτιατική
δημιουργούσε	δημιουργώ	ρήμα	ενεργητική, παρατατικός, οριστική, ενικός, 3ο πρόσωπο
κολυμπώντας	κολυμπώ	ρήμα	ενεργητική, ενεστώτας, μετοχή, , 
φορούσες	φορώ	ρήμα	ενεργητική, παρατατικός, οριστική, ενικός, 2ο πρόσωπο
νικητής	νικητής	ουσιαστικό	αρσενικό, ενικός, ονομαστική
φθόνησα	φθονώ	ρήμα	ενεργητική, αόριστος, οριστική, ενικός, 1ο πρόσωπο
λαμπύριζαν	λαμπυρίζω	ρήμα	ενεργητική, παρατατικός, οριστική, πληθυντικός, 3ο πρόσωπο
παρατηρεί	παρατηρώ	ρήμα	ενεργητική, ενεστώτας, οριστική, ενικός, 3ο πρόσωπο
τσιμπούρια	τσιμπούρι	ουσιαστικό	ουδέτερο, πληθυντικός, αιτιατική
φορητές	φορητός	επίθετο	θηλυκό, πληθυντικός, ονομαστική
κόκκινη	κόκκινος	επίθετο	θηλυκό, ενικός, ονομαστική
κόκκινο	κόκκινος	επίθετο	αρσενικό, ενικός, αιτιατική
βάφονται	βάφω	ρήμα	παθητική, ενεστώτας, οριστική, πληθυντικός, 3ο πρόσωπο
παρακαλούσαν	παρακαλώ	ρήμα	ενεργητική, παρατατικός, οριστική, πληθυντικός, 3ο πρόσωπο
περισσότερο	περισσότερο	επίρρημα	
μεγάλος	μεγάλος	επίθετο	αρσενικό, ενικός, ονομαστική
μεγάλου	μεγάλος	επίθετο	ουδέτερο, ενικός, γενική
κανακέματα	κανάκεμα	ουσιαστικό	ουδέτερο, πληθυντικός, αιτιατική
μεγάλοι	μεγάλος	επίθετο	αρσενικό, πληθυντικός, κλητική
σαράντα	σαράντα	επίθετο	άκλιτο
σημερινού	σημερινός	επίθετο	ουδέτερο, ενικός, γενική
τύμπανο	τύμπανο	ουσιαστικό	ουδέτερο, ενικός, κλητική
κόκκινα	κόκκινος	επίθετο	ουδέτερο, πληθυντικός, αιτιατική
κάμπο	κάμπος	ουσιαστικό	αρσενικό, ενικός, αιτιατική
μεταξύ	μεταξύ	επίρρημα	
κατάνυξη	κατάνυξη	ουσιαστικό	θηλυκό, ενικός, κλητική
κινούσε	κινώ	ρήμα	ενεργητική, παρατατικός, οριστική, ενικός, 3ο πρόσωπο
κείμενο	κείμενο	ουσιαστικό	ουδέτερο, ενικός, κλητική
φύσημα	φύσημα	ουσιαστικό	ουδέτερο, ενικός, κλητική
δωμάτιο	δωμάτιο	ουσιαστικό	ουδέτερο, ενικός, κλητική
γιορτάσει	γιορτάζω	ρήμα	ενεργητική, αόριστος, υποτακτική, ενικός, 3ο πρόσωπο
πολύ	πολύ	επίρρημα	
μπάρα	μπάρα	ουσιαστικό	θηλυκό, ενικός, κλητική
παράμεροι	παράμερος	επίθετο	αρσενικό, πληθυντικός, κλητική
ανορθόδοξα	ανορθόδοξος	επίθετο	ουδέτερο, πληθυντικός, αιτιατική
βατομουριές	βατομουριά	ουσιαστικό	θηλυκό, πληθυντικός, αιτιατική
πέντε	πέντε	επίθετο	άκλιτο
μπάσα	μπάσος	επίθετο	θηλυκό, ενικός, ονομαστική
ζευγάρι	ζευγάρι	ουσιαστικό	ουδέτερο, ενικός, κλητική
κατηγορούμενη	κατηγορούμενος	επίθετο	θηλυκό, ενικός, ονομαστική
παρακαλούν	παρακαλώ	ρήμα	ενεργητική, ενεστώτας, οριστική, πληθυντικός, 3ο πρόσωπο
κοντάρι	κοντάρι	ουσιαστικό	ουδέτερο, ενικός, κλητική
πατέρα	πατέρας	ουσιαστικό	αρσενικό, ενικός, κλητική
χάραμα	χάραμα	ουσιαστικό	ουδέτερο, ενικός, κλητική
φοβήθηκε	φοβούμαι	ρήμα	παθητική, αόριστος, οριστική, ενικός, 3ο πρόσωπο
μπορούσαν	μπορώ	ρήμα	ενεργητική, παρατατικός, οριστική, πληθυντικός, 3ο πρόσωπο
πολυμήχανος	πολυμήχανος	επίθετο	αρσενικό, ενικός, ονομαστική
κουρέλια	κουρέλι	ουσιαστικό	ουδέτερο, πληθυντικός, αιτιατική
νομίζεις	νομίζω	ρήμα	ενεργητική, ενεστώτας, οριστική, ενικός, 2ο πρόσωπο
πουλιού	πουλί	ουσιαστικό	ουδέτερο, ενικός, γενική
φανέλες	φανέλα	ουσιαστικό	θηλυκό, πληθυντικός, αιτιατική
ρώτησε	ρωτώ	ρήμα	ενεργητική, αόριστος, οριστική, ενικός, 3ο πρόσωπο
τεράτων	τέρας	ουσιαστικό	ουδέτερο, πληθυντικός, γενική
παλάτι	παλάτι	ουσιαστικό	ουδέτερο, ενικός, κλητική
χέλι	χέλι	ουσιαστικό	ουδέτερο, ενικός, κλητική
βαρύ	βαρύς	επίθετο	ουδέτερο, ενικός, γενική
συνήθως	συνήθως	επίρρημα	
ρωτήσει	ρωτώ	ρήμα	ενεργητική, αόριστος, υποτακτική, ενικός, 3ο πρόσωπο
ταξιδέψει	ταξιδεύω	ρήμα	ενεργητική, αόριστος, υποτακτική, ενικός, 3ο πρόσωπο
ψιθυρίζει	ψιθυρίζω	ρήμα	ενεργητική, ενεστώτας, οριστική, ενικός, 3ο πρόσωπο
καθαρό	καθαρός	επίθετο	αρσενικό, ενικός, αιτιατική
πόλεμο	πόλεμος	ουσιαστικό	αρσενικό, ενικός, αιτιατική
κατεβάσει	κατεβάζω	ρήμα	ενεργητική, αόριστος, υποτακτική, ενικός, 3ο πρόσωπο
βεράντας	βεράντα	ουσιαστικό	θηλυκό, ενικός, γενική
περιπέτειες	περιπέτεια	ουσιαστικό	θηλυκό, πληθυντικός, αιτιατική
μερικοί	μερικός	επίθετο	αρσενικό, πληθυντικός, κλητική
μπάλα	μπάλα	ουσιαστικό	θηλυκό, ενικός, κλητική
ενδιαίτημα	ενδιαίτημα	ουσιαστικό	ουδέτερο, ενικός, κλητική
κήποι	κήπος	ουσιαστικό	αρσενικό, πληθυντικός, κλητική
σημαντικό	σημαντικός	επίθετο	αρσενικό, ενικός, αιτιατική
θυμίζουν	θυμίζω	ρήμα	ενεργητική, ενεστώτας, οριστική, πληθυντικός, 3ο πρόσωπο
σημαντική	σημαντικός	επίθετο	θηλυκό, ενικός, ονομαστική
παρακολουθούσαν	παρακολουθώ	ρήμα	ενεργητική, παρατατικός, οριστική, πληθυντικός, 3ο πρόσωπο
τσουβάλι	τσουβάλι	ουσιαστικό	ουδέτερο, ενικός, κλητική
σηκώνεται	σηκώνω	ρήμα	παθητική, ενεστώτας, οριστική, ενικός, 3ο πρόσωπο
διαβάσει	διαβάζω	ρήμα	ενεργητική, αόριστος, υποτακτική, ενικός, 3ο πρόσωπο
μπουσουλούσες	μπουσουλώ	ρήμα	ενεργητική, παρατατικός, οριστική, ενικός, 2ο πρόσωπο
πήρε	παίρνω	 ρήμα	 ενεργητική, αόριστος, οριστική, ενικός, τρίτο
καθαρά	καθαρός	επίθετο	ουδέτερο, πληθυντικός, αιτιατική
χαλαρώσει	χαλαρώνω	ρήμα	ενεργητική, αόριστος, υποτακτική, ενικός, 3ο πρόσωπο
παρηγορήσει	παρηγορώ	ρήμα	ενεργητική, αόριστος, υποτακτική, ενικός, 3ο πρόσωπο
κορυφή	κορυφή	ουσιαστικό	θηλυκό, ενικός, κλητική
κατηφορικό	κατηφορικός	επίθετο	αρσενικό, ενικός, αιτιατική
ξεχωρίζουν	ξεχωρίζω	ρήμα	ενεργητική, ενεστώτας, οριστική, πληθυντικός, 3ο πρόσωπο
κολυμπούσε	κολυμπώ	ρήμα	ενεργητική, παρατατικός, οριστική, ενικός, 3ο πρόσωπο
εξόντωση	εξόντωση	ουσιαστικό	θηλυκό, ενικός, κλητική
γαλήνη	γαλήνη	ουσιαστικό	θηλυκό, ενικός, κλητική
φοράνε	φορώ	ρήμα	ενεργητική, ενεστώτας, οριστική, πληθυντικός, 3ο πρόσωπο
ψαλιδωτή	ψαλιδωτός	επίθετο	θηλυκό, ενικός, ονομαστική
ισόπαλο	ισόπαλος	επίθετο	αρσενικό, ενικός, αιτιατική
αθόρυβα	αθόρυβος	επίθετο	ουδέτερο, πληθυντικός, αιτιατική
κουράζεται	κουράζω	ρήμα	παθητική, ενεστώτας, οριστική, ενικός, 3ο πρόσωπο
πάντοτε	πάντοτε	επίρρημα	
πολύτιμο	πολύτιμος	επίθετο	αρσενικό, ενικός, αιτιατική
πολυαγαπημένη	πολυαγαπημένος	επίθετο	θηλυκό, ενικός, ονομαστική
δεκαπέντε	δεκαπέντε	επίθετο	άκλιτο
βεράντες	βεράντα	ουσιαστικό	θηλυκό, πληθυντικός, αιτιατική
ταρακούνησαν	ταρακουνώ	ρήμα	ενεργητική, αόριστος, οριστική, πληθυντικός, 3ο πρόσωπο
δυνατό	δυνατός	επίθετο	αρσενικό, ενικός, αιτιατική
παίξετε	παίζω	ρήμα	ενεργητική, αόριστος, υποτακτική, πληθυντικός, 2ο πρόσωπο
τέλεια	τέλειος	επίθετο	θηλυκό, ενικός, ονομαστική
δυνατά	δυνατός	επίθετο	ουδέτερο, πληθυντικός, αιτιατική
δυνατή	δυνατός	επίθετο	θηλυκό, ενικός, ονομαστική
κοτσάνι	κοτσάνι	ουσιαστικό	ουδέτερο, ενικός, κλητική
